T:T:A:A:A:A:A:A:A:A:A:A:A:A:A:A:A:A:A:A:A:A:A:A:A:A:A:A:T:T
T:T:A:A:A:A:A:A:A:A:A:A:A:A:A:A:A:A:A:A:A:A:A:A:A:A:A:A:T:T
T:T:A:A:A:A:A:A:A:A:A:A:A:A:A:A:A:A:A:A:A:A:A:A:A:A:A:A:T:T
T:T:A:A:A:A:A:A:A:A:A:A:A:A:A:A:A:A:A:A:A:A:A:A:A:A:A:A:T:T
T:T:A:A:A:A:A:A:A:A:A:A:A:A:A:A:A:A:A:A:A:A:A:A:A:A:A:A:T:T
T:T:A:A:A:A:A:A:A:A:A:A:A:A:A:A:A:A:A:A:A:A:A:A:A:A:A:A:T:T
T:T:A:A:A:A:A:A:A:A:A:A:A:A:A:A:A:A:A:A:A:A:A:A:A:A:A:A:T:T
T:T:A:A:A:A:A:A:A:A:A:A:A:A:A:A:A:A:A:A:A:A:A:A:A:A:A:A:T:T
T:T:A:A:A:A:A:A:A:A:A:A:A:A:A:A:A:A:A:A:A:A:A:A:A:A:A:A:T:T
T:T:A:A:A:A:A:A:A:A:A:A:A:A:A:A:A:A:A:A:A:A:A:A:A:A:A:A:T:T
T:T:A:A:A:A:A:A:A:A:A:A:A:A:A:A:A:A:A:A:A:A:A:A:A:A:A:A:T:T
T:T:A:A:A:A:A:A:A:A:A:A:A:A:A:A:A:A:A:A:A:A:A:A:A:A:A:A:T:T
T:T:A:A:A:A:A:A:A:A:A:B:A:A:A:A:B:A:A:A:A:A:A:A:A:A:A:A:T:T
T:T:A:A:A:A:A:A:A:A:A:B:A:A:A:A:B:A:A:A:A:A:A:A:A:A:A:A:T:T
T:T:A:A:A:A:A:A:A:A:A:B:A:A:A:A:B:A:A:A:A:A:A:A:A:A:A:A:T:T
T:T:A:A:A:A:A:A:A:A:A:B:A:A:A:A:B:A:A:A:A:A:A:A:A:A:A:A:T:T
T:T:A:A:A:A:A:A:A:A:A:B:A:A:A:A:B:A:A:A:A:A:A:A:A:A:A:A:T:T
T:T:A:A:A:A:A:A:A:A:A:B:A:A:A:A:B:A:A:A:A:A:A:A:A:A:A:A:T:T
T:T:A:A:A:A:A:A:A:A:A:B:A:A:A:A:B:A:A:A:A:A:A:A:A:A:A:A:T:T
T:T:A:A:A:H:H:H:A:A:A:B:A:A:A:A:B:A:A:A:A:A:A:A:B:B:A:A:T:T
T:T:H:H:H:T:T:T:H:H:H:H:H:H:H:H:H:H:S:S:S:H:H:H:H:H:H:H:T:T
T:T:T:T:T:T:T:T:T:T:T:T:T:T:T:T:T:T:T:T:S:T:T:T:T:T:T:T:T:T
T:T:T:T:T:T:T:T:T:T:T:T:T:T:T:T:T:T:T:T:T:T:T:T:T:T:T:T:T:T
T:T:T:T:T:T:T:T:T:T:T:T:T:T:T:T:T:T:T:T:T:T:T:T:T:T:T:T:T:T
T:T:T:T:T:T:T:T:T:T:T:T:T:T:T:T:T:T:T:T:T:T:T:T:T:T:T:T:T:T
P:P:P:P:P:P:P:P:P:P:P:P:P:P:P:P:P:P:F:P:P:P:P:P:P:P:P:P:P:P
P:P:P:P:P:P:P:P:F:P:P:P:R:P:P:P:P:P:P:P:P:P:P:P:R:P:P:R:P:P
P:P:P:P:P:P:P:P:P:P:R:P:F:P:P:P:F:P:F:F:P:P:P:F:F:P:P:R:P:P
P:P:P:P:P:P:P:P:P:P:P:P:P:P:P:P:P:P:P:P:P:P:P:P:P:P:P:P:P:P
P:P:P:P:P:P:P:P:P:P:P:P:P:P:P:P:P:P:P:P:P:P:P:P:P:P:P:P:P:P
