A:A:A:A:A:A:A:A:A:A:A:A:A:A:A:A:A:A:A:A:A:A:A:A:A:A:A:A:A:A:A:A:A:A:A:A:A:A:A:A:A:A:A:A:A:A:A:A:A:A:A:A:A:A:A:A:A:A:A:A:A:A:A:A:A:A:A:A:A:A:A:A:A:A:A:A:A:A:A:A:A:A:A:A:A:A:A:A:A:A:A:A:A:A:A:A:A:A:A:A
A:A:A:A:A:A:A:A:A:A:A:A:A:A:A:A:A:A:A:A:A:A:A:A:A:A:A:A:A:A:A:A:A:A:A:A:A:A:A:A:A:A:A:A:A:A:A:A:A:A:A:A:A:A:A:A:A:A:A:A:A:A:A:A:A:A:A:A:A:A:A:A:A:A:A:A:A:A:A:A:A:A:A:A:A:A:A:A:A:A:A:A:A:A:A:A:A:A:A:A
A:A:A:A:A:A:A:A:A:A:A:A:A:A:A:A:A:A:A:A:A:A:A:A:A:A:A:A:A:A:A:A:A:A:A:A:A:A:A:A:A:A:A:A:A:A:A:A:A:A:A:A:A:A:A:A:A:A:A:A:A:A:A:A:A:A:A:A:A:A:A:A:A:A:A:A:A:A:A:A:A:A:A:A:A:A:A:A:A:A:A:A:A:A:A:A:A:A:A:A
H:A:A:A:A:A:A:A:A:A:A:A:A:A:A:A:A:A:A:A:A:A:A:A:A:A:A:A:A:A:A:A:A:A:A:A:A:A:A:A:A:A:A:A:A:A:A:A:A:A:A:A:A:A:A:A:A:A:A:A:A:A:A:A:A:A:A:A:A:A:A:A:A:A:A:A:A:A:A:A:A:A:A:A:A:A:A:A:A:A:A:A:A:A:A:A:A:A:A:A
T:H:A:A:A:A:A:A:A:A:A:A:A:A:A:A:A:A:A:A:A:A:A:A:A:A:A:A:A:A:A:A:A:A:A:A:A:A:A:A:A:A:A:A:A:A:A:A:A:A:A:A:A:A:A:A:A:A:A:A:A:A:A:A:A:A:A:A:A:A:A:A:A:A:A:A:A:A:A:A:A:A:A:A:A:A:A:A:A:A:A:A:A:A:A:A:A:A:A:A
T:T:H:A:A:A:A:A:A:A:A:A:A:A:A:A:A:A:A:A:A:A:A:A:A:A:A:A:A:A:A:A:A:A:A:A:A:A:A:A:A:A:A:A:A:A:A:A:A:A:A:A:A:A:A:A:A:A:A:A:A:A:A:A:A:A:A:A:A:A:A:A:A:A:A:A:A:A:A:A:A:A:A:A:A:A:A:A:A:A:A:A:A:A:A:A:A:A:A:A
T:T:T:A:A:A:A:A:A:A:A:A:A:A:A:A:A:A:A:A:A:A:A:A:A:A:A:A:A:A:A:A:A:A:A:A:A:A:A:A:A:A:A:A:A:A:A:A:A:A:A:A:A:A:A:A:A:A:A:A:A:A:A:A:A:A:A:A:A:A:A:A:A:A:A:A:A:A:A:A:A:A:A:A:A:A:A:A:A:A:A:A:A:A:A:A:A:A:A:A
T:T:T:A:A:A:A:A:A:A:A:A:A:A:A:A:A:A:A:A:A:A:A:A:A:A:A:A:A:A:A:A:A:A:A:A:A:A:A:A:A:A:A:A:A:A:A:A:A:A:A:A:A:A:A:A:A:A:A:A:A:A:A:A:A:A:A:A:A:A:A:A:A:A:A:A:A:A:A:A:A:A:A:A:A:A:A:A:A:A:A:A:A:A:A:A:A:A:A:A
T:T:T:H:A:A:A:A:A:A:A:A:A:A:A:A:A:A:A:A:A:A:A:A:A:A:A:A:A:A:A:A:A:A:A:A:A:A:A:A:A:A:A:A:A:A:A:A:A:A:A:A:A:A:A:A:A:A:A:A:A:A:A:A:A:A:A:A:A:A:A:A:A:A:A:A:A:A:B:A:A:A:A:A:A:A:A:A:A:A:A:A:A:A:A:A:A:A:A:A
T:T:T:T:A:A:A:A:A:A:A:A:A:A:A:A:A:A:A:A:A:A:A:A:A:A:A:A:A:A:A:A:A:A:A:A:A:A:A:A:A:A:A:A:A:A:A:A:A:A:A:A:A:A:A:A:A:A:A:A:A:A:A:A:A:A:A:A:A:A:A:A:A:A:A:A:A:A:B:A:A:A:B:A:A:A:A:A:A:A:A:A:A:A:A:A:A:A:A:A
T:T:T:T:A:A:A:A:A:A:A:A:A:A:A:A:A:A:A:A:A:A:A:A:A:A:A:A:A:A:A:A:A:A:A:A:A:A:A:A:A:A:A:A:A:A:A:A:A:A:A:A:A:A:A:A:A:A:A:A:A:A:A:A:A:A:A:A:A:B:A:A:A:A:A:A:A:A:B:B:B:B:A:A:A:A:A:A:A:A:A:A:A:B:A:A:A:A:A:A
T:T:T:T:H:A:A:A:A:A:A:A:A:A:A:A:A:A:A:A:A:A:A:A:A:A:A:A:A:A:A:A:A:A:A:A:A:A:A:A:A:A:A:A:A:A:A:A:A:A:A:A:A:A:A:A:A:A:A:A:A:A:A:A:A:A:A:A:A:B:A:A:A:A:A:A:A:A:B:A:A:A:A:A:A:A:A:A:A:A:A:A:A:A:B:A:A:A:A:A
T:T:T:T:T:A:A:A:A:A:A:A:B:A:A:A:A:A:A:A:A:A:A:A:A:A:A:A:A:A:A:A:A:A:A:A:A:A:A:A:A:A:A:A:A:A:A:A:B:A:A:A:A:A:A:A:A:A:A:A:A:A:A:A:A:A:A:A:A:B:A:A:A:A:A:A:B:B:B:A:A:B:A:A:A:A:A:A:A:A:A:A:A:A:B:A:A:A:A:A
T:T:T:T:T:H:A:A:A:A:A:A:B:A:A:A:A:A:A:A:A:A:A:A:A:A:A:A:A:A:A:A:A:A:A:A:A:A:A:A:A:A:A:A:A:A:A:B:B:A:A:A:A:A:A:A:A:A:A:A:A:A:A:A:A:A:A:A:A:B:B:A:A:B:A:A:A:A:B:B:B:A:A:A:A:A:A:A:A:A:A:A:A:A:B:A:A:A:B:A
T:T:T:T:T:T:A:A:A:A:A:A:B:A:A:B:A:A:A:A:A:A:A:A:A:A:A:A:A:A:A:A:A:A:A:A:A:A:A:A:A:A:A:A:A:A:A:B:A:A:A:A:A:A:A:A:A:A:A:A:A:A:A:A:A:A:A:A:A:A:B:B:B:B:A:A:A:A:B:A:A:A:A:A:A:A:A:A:A:A:A:A:A:A:B:A:A:A:B:A
T:T:T:T:T:T:A:A:A:A:A:A:B:B:B:A:A:A:A:A:A:A:A:A:A:A:A:A:A:A:A:A:A:A:A:A:A:A:A:A:A:A:A:A:A:A:A:B:A:A:A:A:A:A:A:A:A:A:A:A:A:A:A:A:A:A:A:A:A:A:A:A:B:A:A:A:A:A:B:A:A:A:A:A:A:A:A:A:A:A:A:A:A:A:A:B:A:B:A:A
T:T:T:T:T:T:H:A:A:A:A:A:B:A:A:A:A:A:A:A:A:A:A:A:A:A:A:A:A:A:A:A:A:A:A:A:A:A:A:A:A:A:A:A:A:A:A:B:A:A:A:A:A:A:A:A:A:A:A:A:A:A:A:A:A:A:A:A:A:A:A:A:B:A:A:A:A:A:B:A:A:A:A:A:A:A:A:A:A:A:A:A:B:A:A:B:B:A:A:A
T:T:T:T:T:T:T:A:A:A:A:A:B:A:A:A:A:A:A:A:A:A:A:A:A:A:D:A:A:A:A:A:A:A:A:A:A:A:A:A:A:A:A:A:A:A:A:B:A:A:A:A:A:A:A:A:A:A:A:A:A:A:A:A:A:A:A:A:A:A:A:A:B:A:A:A:A:A:B:A:A:A:A:A:A:A:A:A:A:A:A:A:A:B:B:B:A:A:A:A
T:T:T:T:T:T:T:A:A:A:B:B:B:A:A:A:A:A:A:A:A:H:H:H:H:H:H:H:H:A:A:A:A:A:A:A:A:A:A:A:A:A:A:A:A:A:B:B:A:A:A:A:A:A:A:A:A:A:A:A:A:A:A:A:A:D:A:A:A:A:H:H:T:H:A:A:A:H:T:H:A:A:A:A:A:A:A:A:A:A:A:A:A:A:A:B:A:A:A:A
T:T:T:T:T:T:T:H:A:A:A:A:B:A:A:A:A:A:H:H:H:T:T:T:T:T:T:T:T:H:H:A:A:A:A:A:A:A:A:A:A:A:A:A:A:A:B:A:A:A:A:A:A:A:A:A:A:A:A:A:A:H:H:H:H:T:H:H:H:H:T:T:T:T:H:A:A:T:T:T:H:H:A:A:A:A:A:A:A:A:A:A:A:A:A:B:A:A:A:A
T:T:T:T:T:T:T:T:A:A:A:A:B:A:A:A:H:H:T:T:T:T:T:T:T:T:T:T:T:T:T:H:H:I:A:A:A:A:A:A:A:A:A:A:A:A:B:A:A:A:D:D:A:H:H:A:A:A:A:H:H:T:T:T:T:T:T:T:T:T:T:T:T:T:T:H:A:T:T:T:T:T:H:H:H:H:A:A:D:D:D:A:A:A:A:B:A:A:A:A
T:T:T:T:T:T:T:T:H:H:H:H:T:H:H:H:T:T:T:T:T:T:T:T:T:T:T:T:T:T:T:T:T:T:H:H:H:H:H:H:S:S:S:S:S:H:T:H:H:H:T:T:H:T:T:H:A:A:A:T:T:T:T:T:T:T:T:T:T:T:T:T:T:T:T:T:A:T:T:T:T:T:T:T:T:T:H:H:T:T:T:H:H:H:H:T:H:S:S:S
T:T:T:T:T:T:T:T:T:T:T:T:T:T:T:T:T:T:T:T:T:T:T:T:T:T:T:T:T:T:T:T:T:T:T:T:T:T:T:T:T:T:T:T:T:T:T:T:T:T:T:T:T:T:T:T:H:A:H:T:T:T:T:T:T:T:T:T:T:T:T:T:T:T:T:T:I:T:T:T:T:T:T:T:T:T:T:T:T:T:T:T:T:T:T:T:T:T:T:S
T:T:T:T:T:T:T:T:T:T:T:T:T:T:T:T:T:T:T:T:T:T:T:T:T:T:T:T:T:T:T:T:T:T:T:T:T:T:T:T:T:T:T:T:T:T:T:T:T:T:T:T:T:T:T:T:T:H:T:T:T:T:T:T:T:T:T:T:T:T:T:T:T:T:T:T:T:T:T:T:T:T:T:T:T:T:T:T:T:T:T:T:T:T:T:T:T:T:T:T
T:T:T:T:T:T:T:T:T:T:T:T:T:T:T:T:T:T:T:T:T:T:T:T:T:T:T:T:T:T:T:T:T:T:T:T:T:T:T:T:T:T:T:T:T:T:T:T:T:T:T:T:T:T:T:T:T:T:T:T:T:T:T:T:T:T:T:T:T:T:T:T:T:T:T:T:T:T:T:T:T:T:T:T:T:T:T:T:T:T:T:T:T:T:T:T:T:T:T:T
T:T:T:T:T:T:T:T:T:T:T:T:T:T:T:T:T:T:T:T:T:T:T:T:T:T:T:T:T:T:T:T:T:T:T:T:T:T:T:T:T:T:T:T:T:T:T:T:T:T:T:T:T:T:T:T:T:T:T:T:T:T:T:T:T:T:T:T:T:T:T:T:T:T:T:T:T:T:T:T:T:T:T:T:T:T:T:T:T:T:T:T:T:T:T:T:T:T:T:T
T:T:T:T:T:T:T:T:T:T:T:T:T:T:T:T:T:T:T:T:T:T:T:T:T:T:T:T:T:T:T:T:T:T:T:T:T:T:T:T:T:T:T:T:T:T:T:T:T:T:T:T:T:T:T:T:T:T:T:T:T:T:T:T:T:T:T:T:T:T:T:T:T:T:T:T:T:T:T:T:T:T:T:T:T:T:T:T:T:T:T:T:T:T:T:T:T:T:T:T
T:T:P:T:T:P:P:T:T:T:T:T:T:T:T:T:T:T:T:T:T:T:T:T:T:T:T:T:T:T:T:T:T:T:T:T:T:T:T:T:T:T:T:T:T:T:T:P:P:P:T:T:T:T:T:T:T:T:T:T:P:T:T:T:T:T:T:T:T:T:T:T:T:T:T:T:T:T:T:T:T:T:T:T:T:T:T:T:T:T:T:T:T:T:T:T:T:T:T:T
P:P:P:P:P:P:P:P:P:P:P:P:P:P:P:P:T:T:T:T:T:T:T:T:P:P:P:P:P:P:R:P:P:P:P:P:P:T:T:T:T:T:P:P:P:P:P:P:P:P:P:P:P:P:P:P:P:P:P:P:P:P:P:P:P:P:P:P:P:P:P:P:P:P:P:P:P:P:P:T:T:T:T:P:P:P:T:T:T:T:T:T:T:T:T:T:T:T:T:T
P:P:P:P:P:P:P:P:P:P:P:P:P:P:P:P:P:P:P:P:P:T:T:T:P:P:P:P:P:P:P:P:P:P:P:P:P:P:P:P:P:P:P:P:P:P:P:P:P:P:P:P:P:P:P:P:P:P:P:P:P:P:P:P:F:P:P:P:P:P:P:P:P:P:P:P:P:P:P:P:T:T:P:P:P:P:P:T:T:T:T:T:T:P:P:P:P:T:T:T
P:P:P:P:R:P:P:P:P:P:P:P:P:P:P:P:P:P:P:P:P:P:P:T:P:P:P:P:P:P:P:P:P:P:R:P:P:P:P:P:P:P:P:P:P:P:P:P:D:P:P:P:P:P:P:P:P:P:P:P:P:P:P:P:P:P:P:P:P:P:P:P:P:P:P:P:P:P:P:P:T:P:P:P:P:P:P:P:P:P:P:P:P:P:P:P:P:R:T:T
P:P:P:P:P:P:P:P:P:P:P:P:P:P:P:P:P:P:P:P:P:P:P:P:P:P:P:P:P:P:P:P:P:P:P:P:P:P:P:P:P:P:P:P:P:P:P:P:P:P:P:P:P:P:P:P:P:P:P:P:P:P:P:P:P:P:P:P:P:P:P:P:F:F:P:P:P:P:P:P:P:P:P:P:P:P:P:P:P:P:P:P:P:P:P:P:P:P:P:P
P:P:P:P:P:P:P:P:P:P:P:P:P:P:P:D:P:P:P:P:P:P:P:P:P:P:P:P:P:P:P:P:P:P:P:P:P:P:P:P:P:P:P:P:P:P:P:P:P:P:P:P:P:P:P:P:P:P:P:P:P:P:P:P:P:P:P:P:P:P:P:P:P:P:P:P:P:P:P:P:P:P:P:P:P:P:P:P:P:P:P:P:P:P:P:P:P:P:P:P
P:P:P:P:P:P:P:P:P:P:P:P:P:P:P:P:P:P:P:P:P:P:P:P:R:P:P:P:P:P:P:P:P:P:P:P:P:R:P:P:P:P:P:P:P:P:P:P:P:P:P:P:P:P:P:P:P:P:P:P:P:P:P:P:P:P:P:P:P:P:P:P:P:P:P:P:P:P:P:P:P:P:P:P:P:P:P:P:P:P:P:P:P:P:P:P:P:P:P:P
P:P:P:P:P:P:P:P:P:P:P:P:P:P:P:P:P:P:P:R:P:P:P:P:P:P:P:P:P:P:P:P:P:P:P:P:P:P:P:P:P:P:P:P:P:P:P:P:P:P:P:P:P:P:F:F:P:P:P:P:P:P:P:P:P:P:P:P:P:P:P:P:P:P:P:P:P:P:P:P:P:P:R:P:P:S:S:S:S:P:P:P:P:P:P:P:P:P:P:P
P:P:P:P:P:P:P:P:P:P:P:P:P:P:P:P:P:P:P:P:P:P:P:P:P:P:P:P:P:P:P:P:P:P:P:P:P:P:P:P:P:P:P:P:P:P:P:P:P:P:P:P:P:P:F:F:P:P:P:P:P:P:P:P:P:P:P:P:P:P:P:P:P:P:P:P:P:P:P:F:F:A:A:S:S:S:S:S:S:P:P:P:P:P:P:P:P:P:P:P
P:P:P:P:P:P:P:P:P:P:P:P:P:P:P:P:P:P:P:P:P:P:P:P:P:P:P:P:P:P:P:P:P:P:P:P:P:P:P:P:P:P:P:P:P:P:P:P:P:P:P:P:P:P:P:P:P:P:P:P:P:P:P:P:P:P:P:P:P:P:P:D:P:P:P:P:P:P:P:F:A:A:A:P:S:S:S:S:P:P:P:P:P:P:P:P:P:P:P:P
P:P:P:P:P:P:P:P:P:P:P:P:P:P:P:P:P:P:P:P:P:P:P:P:P:P:P:P:P:P:P:P:P:F:F:F:P:P:P:P:P:P:P:P:P:P:P:P:P:P:P:P:P:P:P:P:P:P:P:P:P:P:P:P:P:P:F:P:P:P:P:P:P:P:P:P:P:A:A:A:A:A:P:P:P:P:S:S:P:P:P:P:P:P:P:P:P:P:P:P
P:P:P:P:P:P:P:P:P:P:P:P:P:P:P:P:P:P:P:P:P:P:P:P:P:P:P:P:P:P:P:P:P:P:P:P:P:P:P:P:P:P:P:P:P:P:P:P:P:P:P:P:P:P:P:P:P:P:P:P:P:P:P:P:P:P:P:P:P:P:P:P:P:R:R:P:R:A:A:A:A:A:P:P:P:P:P:P:P:P:P:P:P:P:P:P:P:P:P:P
P:P:P:P:P:P:P:P:P:P:P:P:P:P:P:P:P:P:P:P:P:P:P:P:P:P:P:P:P:P:P:P:P:P:P:P:P:P:P:P:P:P:P:P:P:P:P:P:P:P:P:P:P:P:P:P:P:P:P:P:P:P:P:P:P:P:P:P:P:P:P:P:P:P:P:P:A:A:A:A:P:P:P:P:P:P:P:P:P:P:P:P:P:P:P:P:P:P:P:P
P:P:P:P:P:P:P:P:P:P:P:P:P:P:P:P:P:P:P:P:P:P:P:P:P:P:P:P:P:P:P:P:P:P:P:P:P:P:P:P:P:P:P:P:P:P:P:P:P:P:P:P:P:P:P:P:P:P:P:P:P:P:P:P:P:P:P:P:P:P:P:P:P:P:P:A:A:A:A:A:P:P:P:P:P:P:P:P:P:P:P:P:P:P:P:P:P:P:P:P
P:P:P:P:F:F:P:P:P:P:D:P:P:P:P:P:P:P:R:P:P:P:P:P:P:P:P:P:P:P:P:P:P:P:P:P:P:P:P:P:P:P:D:D:P:P:P:P:P:P:P:P:P:P:P:P:P:P:P:P:P:D:P:P:P:P:P:P:P:P:P:A:A:A:A:A:A:A:A:I:P:P:P:P:P:P:P:P:P:P:P:P:P:P:P:P:P:P:P:P
P:P:P:F:F:F:F:P:P:P:P:P:P:P:P:P:P:P:R:P:P:P:P:P:P:P:P:P:P:P:P:P:P:P:R:P:P:P:P:P:P:P:P:P:P:P:P:P:P:P:P:P:P:P:P:P:P:P:P:P:P:P:P:P:P:P:P:P:P:F:F:F:A:A:A:A:A:A:P:P:P:P:P:P:P:P:P:P:P:P:P:P:P:P:P:P:P:P:P:P
P:P:F:F:R:R:F:P:P:P:P:P:P:P:P:P:P:R:R:P:P:P:P:P:P:P:A:P:R:P:P:P:P:P:R:P:P:P:P:P:P:P:P:P:P:P:P:P:P:P:P:P:P:P:P:P:P:P:P:P:P:P:P:P:P:P:P:P:P:P:P:P:P:P:P:F:F:F:P:P:P:P:P:P:P:P:P:P:P:P:P:P:P:P:P:P:P:P:P:P
P:P:F:F:R:R:F:F:P:P:P:P:P:P:P:P:P:P:P:P:P:P:A:A:A:A:A:P:P:P:P:P:P:P:P:P:P:P:P:P:P:P:P:P:P:P:P:P:P:P:P:P:P:P:P:P:P:P:P:P:P:P:P:P:P:P:P:P:P:P:P:P:P:P:P:P:P:R:R:P:P:P:P:P:P:P:P:P:P:P:P:P:P:P:F:P:P:P:P:P
P:P:P:R:R:R:R:P:P:P:P:P:P:P:P:P:P:P:P:P:P:A:A:A:A:A:A:P:P:P:P:R:P:P:P:P:P:P:P:P:P:P:P:P:P:P:P:P:P:P:P:P:P:P:P:P:P:P:P:P:P:P:P:P:P:P:R:P:P:P:P:P:P:P:P:P:P:P:P:P:P:P:P:P:P:P:P:P:P:P:P:P:P:P:F:F:P:P:P:P
P:P:P:R:I:R:R:P:P:P:P:P:P:P:P:P:P:P:P:P:A:A:A:A:A:A:A:P:P:P:P:P:P:P:P:P:P:P:P:P:P:P:P:P:P:P:P:P:P:P:P:P:P:P:P:P:P:P:P:P:P:P:P:P:P:P:P:P:P:P:P:P:P:P:P:P:P:P:P:P:P:P:P:P:P:P:P:P:P:P:P:P:P:P:F:F:F:P:P:P
P:P:P:R:R:R:R:P:P:P:P:P:P:P:P:P:P:P:P:P:P:D:I:D:A:P:P:P:P:P:P:P:P:P:P:P:P:P:P:P:P:P:P:P:P:P:P:P:P:P:P:F:F:F:P:P:P:P:P:P:R:P:P:P:P:P:P:P:P:P:P:P:P:P:P:P:P:P:P:P:P:P:R:P:P:P:P:P:P:P:P:P:P:P:P:P:P:P:P:P
X:X:X:X:X:X:X:X:X:X:X:X:X:X:X:X:X:X:X:X:X:X:X:X:X:X:X:X:X:X:X:X:X:X:X:X:X:X:X:X:X:X:X:X:X:X:X:X:X:X:X:F:X:X:X:X:X:X:X:X:X:X:X:X:X:X:X:X:X:X:R:X:X:X:X:X:X:X:X:X:X:X:X:X:X:X:X:X:X:X:X:X:X:X:X:X:X:X:X:X
X:X:X:X:X:X:X:X:X:X:X:X:X:X:X:X:X:X:X:X:X:X:X:X:X:X:X:X:X:X:X:X:X:X:X:X:X:X:X:X:X:X:X:X:X:X:X:X:X:X:X:X:X:X:X:X:X:X:X:X:X:X:X:X:X:X:X:X:X:X:X:X:X:X:X:X:X:X:X:X:X:X:X:X:X:X:X:X:X:X:X:X:X:X:X:X:X:X:X:X
