A:A:A:A:A:A:A:A:A:A:A:A:A:A:A:A:A:A:A:A:A:A:A:A:A:A:A:A:A:A:A:A:A:A:A:A:A:A:A:A:A:A:A:A:A:A:A:A:A:A:A:A:A:A:A:A:A:A:A:A:A:A:A:A:A:A:A:A:A:A:A:A:A:A:A:A:A:A:A:A:A:A:A:A:A:A:A:A:A:A:A:A:A:A:A:A:A:A:A:A:A:A:A:A:A:A:A:A:A:A:A:A:A:A:A:A:A:A:A:A:A:A:A:A:A:A:A:A:A:A:A:A:A:A:A:A:A:A:A:A:A:A:A:A:A:A:A:A:A:A:A:A:A:A:A:A:A:A:A:A:A:A:A:A:A:A:A:A:A:A:A:A:A:A:A:A:A:A:A:A:A:A:A:A:A:A:A:A:A:A:A:A:A:A:A:A:A:A:A:A
A:A:A:A:A:A:A:A:A:A:A:A:A:A:A:A:A:A:A:A:A:A:A:A:A:A:A:A:A:A:A:A:A:A:A:A:A:A:A:A:A:A:A:A:A:A:A:A:A:A:A:A:A:A:A:A:A:A:A:A:A:A:A:A:A:A:A:A:A:A:A:A:A:A:A:A:A:A:A:A:A:A:A:A:A:A:A:A:A:A:A:A:A:A:A:A:A:A:A:A:A:A:A:A:A:A:A:A:A:A:A:A:A:A:A:A:A:A:A:A:A:A:A:A:A:A:A:A:A:A:A:A:A:A:A:A:A:A:A:A:A:A:A:A:A:A:A:A:A:A:A:A:A:A:A:A:A:A:A:A:A:A:A:A:A:A:A:A:A:A:A:A:A:A:A:A:A:A:A:A:A:A:A:A:A:A:A:A:A:A:A:A:A:A:A:A:A:A:A:A
A:A:A:A:A:A:A:A:A:A:A:A:A:A:A:A:A:A:A:A:A:A:A:A:A:A:A:A:A:A:A:A:A:A:A:A:A:A:A:A:A:A:A:A:A:A:A:A:A:A:A:A:A:A:A:A:A:A:A:A:A:A:A:A:A:A:A:A:A:A:A:A:A:A:A:A:A:A:A:A:A:A:A:A:A:A:A:A:A:A:A:A:A:A:A:A:A:A:A:A:A:A:A:A:A:A:A:A:A:A:A:A:A:A:A:A:A:A:A:A:A:A:A:A:A:A:A:A:A:A:A:A:A:A:A:A:A:A:A:A:A:A:A:A:A:A:A:A:A:A:A:A:A:A:A:A:A:A:A:A:A:A:A:A:A:A:A:A:A:A:A:A:A:A:A:A:A:A:A:A:A:A:A:A:A:A:A:A:A:A:A:A:A:A:A:A:A:A:A:A
T:A:A:A:A:A:A:A:A:A:A:A:A:A:A:A:A:A:A:A:A:A:A:A:A:A:A:A:A:A:A:A:A:A:A:A:A:A:A:A:A:A:A:A:A:A:A:A:A:A:A:A:A:A:A:A:A:A:A:A:A:A:A:A:A:A:A:A:A:A:A:A:A:A:A:A:A:A:A:A:A:A:A:A:A:A:A:A:A:A:A:A:A:A:A:A:A:A:A:A:A:A:A:A:A:A:A:A:A:A:A:A:A:A:A:A:A:A:A:A:A:A:A:A:A:A:A:A:A:A:A:A:A:A:A:A:A:A:A:A:A:A:A:A:A:A:A:A:A:A:A:A:A:A:A:A:A:A:A:A:A:A:A:A:A:A:A:A:A:A:A:A:A:A:A:A:A:A:A:A:A:A:A:A:A:A:A:A:A:A:A:A:A:A:A:A:A:A:A:A
T:T:A:A:A:A:A:A:A:A:A:A:A:A:A:A:A:A:A:A:A:A:A:A:A:A:A:A:A:A:A:A:A:A:A:A:A:A:A:A:A:A:A:A:A:A:A:A:A:A:A:A:A:A:A:A:A:A:A:A:A:A:A:A:A:A:A:A:A:A:A:A:A:A:A:A:A:A:A:A:A:A:A:A:A:A:A:A:A:A:A:A:A:A:A:A:A:A:A:A:A:A:A:A:A:A:A:A:A:A:A:A:A:A:A:A:A:A:A:A:A:A:A:A:A:A:A:A:A:A:A:A:A:A:A:A:A:A:A:A:A:A:A:A:A:A:A:A:A:A:A:A:A:A:A:A:A:A:A:A:A:A:A:A:A:A:A:A:A:A:A:A:A:A:A:A:A:A:A:A:A:A:A:A:A:A:A:A:A:A:A:A:A:A:A:A:A:A:A:A
T:T:T:A:A:A:A:A:A:A:A:A:A:A:A:A:A:A:A:A:A:A:A:A:A:A:A:A:A:A:A:A:A:A:A:A:A:A:A:A:A:A:A:A:A:A:A:A:A:A:A:A:A:A:A:A:A:A:A:A:A:A:A:A:A:A:A:A:A:A:A:A:A:A:A:A:A:A:A:A:A:A:A:A:A:A:A:A:A:A:A:A:A:A:A:A:A:A:A:A:A:A:A:A:A:A:A:A:A:A:A:A:A:A:A:A:A:A:A:A:A:A:A:A:A:A:A:A:A:A:A:A:A:A:A:A:A:A:A:A:A:A:A:A:A:A:A:A:A:A:A:A:A:A:A:A:A:A:A:A:A:A:A:A:A:A:A:A:A:A:A:A:A:A:A:A:A:A:A:A:A:A:A:A:A:A:A:A:A:A:A:A:A:A:A:A:A:A:A:A
T:T:T:A:A:A:A:A:A:A:A:A:A:A:A:A:A:A:A:A:A:A:A:A:A:A:A:A:A:A:A:A:A:A:A:A:A:A:A:A:A:A:A:A:A:A:A:A:A:A:A:A:A:A:A:A:A:A:A:A:A:A:A:A:A:A:A:A:A:A:A:A:A:A:A:A:A:A:A:A:A:A:A:A:A:A:A:A:A:A:A:A:A:A:A:A:A:A:A:A:A:A:A:A:A:A:A:A:A:A:A:A:A:A:A:A:A:A:A:A:A:A:A:A:A:A:A:A:A:A:A:A:A:A:A:A:A:A:A:A:A:A:A:A:A:A:A:A:A:A:A:A:A:A:A:A:A:A:A:A:A:A:A:A:A:A:A:A:A:A:A:A:A:A:A:A:A:A:A:A:A:A:A:A:A:A:A:A:A:A:A:A:A:A:A:A:A:A:A:A
T:T:T:A:A:A:A:A:A:A:A:A:A:A:A:A:A:A:A:A:A:A:A:A:A:A:A:A:A:A:A:A:A:A:A:A:A:A:A:A:A:A:A:A:A:A:A:A:A:A:A:A:A:A:A:A:A:A:A:A:A:A:A:A:A:A:A:A:A:A:A:A:A:A:A:A:A:A:A:A:A:A:A:A:A:A:A:A:A:A:A:A:A:A:A:A:A:A:A:A:A:A:A:A:A:A:A:A:A:A:A:A:A:A:A:A:A:A:A:A:A:A:A:A:A:A:A:A:A:A:A:A:A:A:A:A:A:A:A:A:A:A:A:A:A:A:A:A:A:A:A:A:A:A:A:A:A:A:A:A:A:A:A:A:A:A:A:A:A:A:A:A:A:A:A:A:A:A:A:A:A:A:A:A:A:A:A:A:A:A:A:A:A:A:A:A:A:A:A:A
T:T:T:T:A:A:A:A:A:A:A:A:A:A:A:A:A:A:A:A:A:A:A:A:A:A:A:A:A:A:A:A:A:A:A:A:A:A:A:A:A:A:A:A:A:A:A:A:A:A:A:A:A:A:A:A:A:A:A:A:A:A:A:A:A:A:A:A:A:A:A:A:A:A:A:A:A:A:B:A:A:A:A:A:A:A:A:A:A:A:A:A:A:A:A:A:A:A:A:A:A:A:A:A:A:A:A:A:A:A:A:A:A:A:A:A:A:A:A:A:A:A:A:A:A:A:A:A:A:A:A:A:A:A:A:A:A:A:A:A:A:A:A:A:A:A:A:A:A:A:A:A:A:A:A:A:A:A:A:A:A:A:A:A:A:A:A:A:A:A:A:A:B:A:A:A:A:B:B:A:A:A:A:A:A:A:A:A:A:A:A:A:A:A:A:A:A:A:A:A
T:T:T:T:A:A:A:A:A:A:A:A:A:A:A:A:A:A:A:A:A:A:A:A:A:A:A:A:A:A:A:A:A:A:A:A:A:A:A:A:A:A:A:A:A:A:A:A:A:A:A:A:A:A:A:A:A:A:A:A:A:A:A:A:A:A:A:A:A:A:A:A:A:A:A:A:A:A:B:A:A:A:B:A:A:A:A:A:A:A:A:A:A:A:A:A:A:A:A:A:A:A:A:A:A:A:A:A:A:A:A:A:A:A:A:A:A:A:A:A:A:A:A:A:A:A:A:A:A:A:A:A:A:A:A:A:A:A:A:A:A:A:A:A:A:A:A:A:A:A:A:A:A:A:A:A:A:A:A:A:A:A:A:A:A:A:A:A:A:A:A:A:A:B:A:A:A:B:A:A:A:A:A:A:A:A:A:A:A:A:A:A:A:A:A:A:A:A:A:A
T:T:T:T:A:A:A:A:A:A:A:A:A:A:A:A:A:A:A:A:A:A:A:A:A:A:A:A:A:A:A:A:A:A:A:A:A:A:A:A:A:A:A:A:A:A:A:A:A:A:A:A:A:A:A:A:A:A:A:A:A:A:A:A:A:A:A:A:A:B:A:A:A:A:A:A:A:A:B:B:B:B:A:A:A:A:A:A:A:A:A:A:A:B:A:A:A:A:A:A:A:A:A:A:A:A:A:A:A:A:A:A:A:A:A:A:A:A:A:A:A:A:A:A:A:A:A:A:A:A:A:A:A:A:A:A:A:A:A:A:A:A:A:A:A:A:A:A:A:A:A:A:A:A:A:A:A:A:A:A:A:A:A:A:A:A:A:A:A:A:A:A:A:B:B:B:B:B:A:A:A:A:A:A:A:A:A:A:A:A:A:A:A:A:A:A:A:A:A:A
T:T:T:T:T:A:A:A:A:A:A:A:A:A:A:A:A:A:A:A:A:A:A:A:A:A:A:A:A:A:A:A:A:A:A:A:A:A:A:A:A:A:A:A:A:A:A:A:A:A:A:A:A:A:A:A:A:A:A:A:A:A:A:A:A:A:A:A:A:B:A:A:A:A:A:A:A:A:B:A:A:A:A:A:A:A:A:A:A:A:A:A:A:A:B:A:A:A:A:A:A:A:A:A:A:A:A:A:A:A:A:A:A:A:A:A:A:A:A:A:A:A:A:A:A:A:A:A:A:A:A:A:A:A:A:A:A:A:A:A:A:A:A:A:A:A:A:A:A:A:A:A:A:A:A:A:A:A:A:A:A:A:A:A:A:A:A:A:A:A:A:A:A:A:A:B:B:A:A:A:A:A:A:A:A:A:A:A:A:A:A:A:A:A:A:A:A:A:A:A
T:T:T:T:T:A:A:A:A:A:A:A:B:A:A:A:A:A:A:A:A:A:A:A:A:A:A:A:A:A:A:A:A:A:A:A:A:A:A:A:A:A:A:A:A:A:A:A:B:A:A:A:A:A:A:A:A:A:A:A:A:A:A:A:A:A:A:A:A:B:A:A:A:A:A:A:B:B:B:A:A:B:A:A:A:A:A:A:A:A:A:A:A:A:B:A:A:A:A:A:A:A:A:A:A:A:A:A:A:A:A:A:A:A:A:A:A:A:A:A:A:A:A:A:A:A:A:A:A:A:A:A:A:A:A:A:A:A:A:A:A:A:A:A:A:A:A:A:A:B:A:A:A:A:A:A:A:A:A:A:A:A:A:A:A:A:A:A:A:A:A:A:A:A:A:B:B:B:A:A:A:A:A:A:A:A:A:A:A:A:A:A:A:A:A:A:A:A:A:A
T:T:T:T:T:T:A:A:A:A:A:A:B:A:A:A:A:A:A:A:A:A:A:A:A:A:A:A:A:A:A:A:A:A:A:A:A:A:A:A:A:A:A:A:A:A:A:B:B:A:A:A:A:A:A:A:A:A:A:A:A:A:A:A:A:A:A:A:A:B:B:A:A:B:A:A:A:A:B:B:B:A:A:A:A:A:A:A:A:A:A:A:A:A:B:A:A:A:B:A:A:A:A:A:A:A:A:A:A:A:A:A:A:A:A:A:A:A:A:A:A:A:A:A:A:A:A:A:A:A:A:A:A:A:A:A:A:A:A:A:A:A:A:A:A:A:A:A:A:B:B:A:A:A:A:A:A:A:A:A:A:A:A:A:A:A:A:A:A:A:A:A:A:A:A:B:A:A:B:B:A:A:A:A:A:A:A:A:A:A:A:A:A:A:A:A:A:A:A:A
T:T:T:T:T:T:A:A:A:A:A:A:B:A:A:B:A:A:A:A:A:A:A:A:A:A:A:A:A:A:A:A:A:A:A:A:A:A:A:A:A:A:A:A:A:A:A:B:A:A:A:A:A:A:A:A:A:A:A:A:A:A:A:A:A:A:A:A:A:A:B:B:B:B:A:A:A:A:B:A:A:A:A:A:A:A:A:A:A:A:A:A:A:A:B:A:A:A:B:A:A:A:A:A:A:A:A:A:A:A:A:A:A:A:A:A:A:A:A:A:A:A:A:A:A:A:A:A:A:A:A:A:A:A:A:A:A:A:A:A:A:A:A:A:A:A:A:A:A:A:B:A:A:B:A:A:A:A:A:A:A:A:A:A:A:A:A:A:A:A:A:A:A:A:A:B:A:A:A:A:A:A:A:A:A:A:A:A:A:A:A:A:A:A:A:A:A:A:A:A
T:T:T:T:T:T:A:A:A:A:A:A:B:B:B:A:A:A:A:A:A:A:A:A:A:A:A:A:A:A:A:A:A:A:A:A:A:A:A:A:A:A:A:A:A:A:A:B:A:A:A:A:A:A:A:A:A:A:A:A:A:A:A:A:A:A:A:A:A:A:A:A:B:A:A:A:A:A:B:A:A:A:A:A:A:A:A:A:A:A:A:A:A:A:A:B:A:B:A:A:A:A:A:A:A:A:A:A:A:A:A:A:A:A:A:A:A:A:A:A:A:A:A:A:A:A:A:A:A:A:A:A:A:A:A:A:A:A:A:A:A:A:A:A:A:A:A:A:A:A:B:A:B:B:A:A:A:A:A:A:A:A:A:A:A:A:A:A:A:A:A:A:A:A:A:B:A:A:A:A:A:A:A:A:A:A:A:A:A:A:A:A:A:A:A:A:T:T:T:A
T:T:T:T:T:T:T:A:A:A:A:A:B:A:A:A:A:A:A:A:A:A:A:A:A:A:A:A:A:A:A:A:A:A:A:A:A:A:A:A:A:A:A:A:A:A:A:B:A:A:A:A:A:A:A:A:A:A:A:A:A:A:A:A:A:A:A:A:A:A:A:A:B:A:A:A:A:A:B:A:A:A:A:A:A:A:A:A:A:A:A:A:B:A:A:B:B:A:A:A:A:A:A:A:A:A:A:A:A:A:A:A:A:A:A:A:A:B:A:A:A:A:A:A:A:A:A:A:A:A:A:A:A:A:A:A:A:A:A:A:A:A:A:A:A:A:A:A:A:A:B:B:B:A:A:A:A:A:A:A:A:A:A:A:A:A:A:A:A:A:A:A:A:A:A:B:A:A:A:A:A:A:A:A:A:A:A:A:A:A:A:A:A:A:A:A:T:T:T:T
T:T:T:T:T:T:T:A:A:A:A:A:B:A:A:A:A:A:A:A:A:A:A:A:A:A:D:A:A:A:A:A:A:A:A:A:A:A:A:A:A:A:A:A:A:A:A:B:A:A:A:A:A:A:A:A:A:A:A:A:A:A:A:A:A:A:A:A:A:A:A:A:B:A:A:A:A:A:B:A:A:A:A:A:A:A:A:A:A:A:A:A:A:B:B:B:A:A:A:A:A:A:A:A:A:A:A:A:A:A:A:A:A:A:A:A:A:A:B:A:A:A:A:A:A:A:B:A:A:A:A:T:T:T:T:T:T:T:A:A:A:A:A:A:A:A:A:A:A:A:A:B:A:A:A:A:A:A:A:A:A:A:A:A:A:A:A:A:A:A:A:A:A:A:A:B:A:A:A:A:A:A:A:A:A:A:A:A:A:A:A:A:A:A:T:T:T:T:T:T
T:T:T:T:T:T:T:A:A:A:B:B:B:A:A:A:A:A:A:A:A:T:T:T:T:T:T:T:T:A:A:A:A:A:A:A:A:A:A:A:A:A:A:A:A:A:B:B:A:A:A:A:A:A:A:A:A:A:A:A:A:A:A:A:A:D:A:A:A:A:T:T:T:T:A:A:A:T:T:T:A:A:A:A:A:A:A:A:A:A:A:A:A:A:A:B:A:A:A:A:A:A:A:A:A:A:A:A:A:A:A:A:A:A:A:B:B:B:B:B:B:B:A:A:A:A:B:I:A:T:T:T:T:T:T:T:T:T:T:T:A:A:A:A:A:A:A:A:A:A:A:B:A:A:A:A:A:A:A:A:A:A:A:A:A:A:A:A:A:A:A:T:T:T:T:T:T:A:A:A:A:A:A:A:A:A:A:A:A:A:A:A:A:A:T:T:T:T:T:T
T:T:T:T:T:T:T:T:A:A:A:A:B:A:A:A:A:A:T:T:T:T:T:T:T:T:T:T:T:T:T:A:A:A:A:A:A:A:A:A:A:A:A:A:A:A:B:A:A:A:A:A:A:A:A:A:A:A:A:A:A:T:T:T:T:T:T:T:T:T:T:T:T:T:T:A:A:T:T:T:T:T:A:A:A:A:A:A:A:A:A:A:A:A:A:B:A:A:A:A:A:A:A:A:A:A:A:A:A:T:T:T:T:T:T:T:T:T:T:T:T:T:T:T:T:T:T:T:T:T:T:T:T:T:T:T:T:T:T:T:T:T:A:A:A:A:A:A:A:A:A:B:A:A:A:A:A:A:A:A:A:T:T:T:T:T:T:T:T:T:T:T:T:T:T:T:T:T:T:A:A:A:A:A:A:A:A:A:A:A:A:A:A:T:T:T:T:T:T:T
T:T:T:T:T:T:T:T:A:A:A:A:B:A:A:A:T:T:T:T:T:T:T:T:T:T:T:T:T:T:T:T:T:I:A:A:A:A:A:A:A:A:A:A:A:A:B:A:A:A:D:D:A:T:T:A:A:A:A:T:T:T:T:T:T:T:T:T:T:T:T:T:T:T:T:T:A:T:T:T:T:T:T:T:T:T:A:A:D:D:D:A:A:A:A:B:A:A:A:A:A:A:A:A:I:S:S:S:T:T:T:T:T:T:T:T:T:T:T:T:T:T:T:T:T:T:T:T:T:T:T:T:T:T:T:T:T:T:T:T:T:T:T:T:A:A:A:A:A:A:A:B:A:A:A:A:A:A:T:T:T:T:T:T:T:T:T:T:T:T:T:T:T:T:T:T:T:T:T:T:T:T:A:A:A:A:A:A:A:A:A:A:T:T:T:T:T:T:T:T
T:T:T:T:T:T:T:T:T:T:T:T:T:T:T:T:T:T:T:T:T:T:T:T:T:T:T:T:T:T:T:T:T:T:T:T:T:T:T:T:S:S:S:S:S:T:T:T:T:T:T:T:T:T:T:T:A:A:A:T:T:T:T:T:T:T:T:T:T:T:T:T:T:T:T:T:A:T:T:T:T:T:T:T:T:T:T:T:T:T:T:T:T:T:T:T:T:S:S:S:S:S:S:S:S:S:S:T:T:T:T:T:T:T:T:T:T:T:T:T:T:T:T:T:T:T:T:T:T:T:T:T:T:T:T:T:T:T:T:T:T:T:T:T:S:S:S:S:S:T:T:T:T:T:T:T:T:T:T:T:T:T:T:T:T:T:T:T:T:T:T:T:T:T:T:T:T:T:T:T:T:T:T:T:T:T:T:T:T:T:T:T:T:T:T:T:T:T:T:T
T:T:T:T:T:T:T:T:T:T:T:T:T:T:T:T:T:T:T:T:T:T:T:T:T:T:T:T:T:T:T:T:T:T:T:T:T:T:T:T:T:T:T:T:T:T:T:T:T:T:T:T:T:T:T:T:T:A:T:T:T:T:T:T:T:T:T:T:T:T:T:T:T:T:T:T:I:T:T:T:T:T:T:T:T:T:T:T:T:T:T:T:T:T:T:T:T:T:T:S:S:D:S:S:S:S:S:T:T:T:T:T:T:T:T:T:T:T:T:T:T:T:T:T:T:T:T:T:T:T:T:T:T:T:T:T:T:T:T:T:T:T:T:T:S:S:S:T:T:T:T:T:T:T:T:T:T:T:T:T:T:T:T:T:T:T:T:T:T:T:T:T:T:T:T:T:T:T:T:T:T:T:T:T:T:T:T:T:T:T:T:T:T:T:T:T:T:T:T:T
T:T:T:T:T:T:T:T:T:T:T:T:T:T:T:T:T:T:T:T:T:T:T:T:T:T:T:T:T:T:T:T:T:T:T:T:T:T:T:T:T:T:T:T:T:T:T:T:T:T:T:T:T:T:T:T:T:T:T:T:T:T:T:T:T:T:T:T:T:T:T:T:T:T:T:T:T:T:T:T:T:T:T:T:T:T:T:T:T:T:T:T:T:T:T:T:T:T:T:T:T:S:S:S:T:T:T:T:T:T:T:T:T:T:T:T:T:T:T:T:T:T:T:T:T:T:T:T:T:T:T:T:T:T:T:T:T:T:T:T:T:T:T:T:T:T:T:T:T:T:T:T:T:T:T:T:T:T:T:T:T:T:T:T:T:T:T:T:T:T:T:T:T:T:T:T:T:T:T:T:T:T:T:T:T:T:T:T:T:T:T:T:T:T:T:T:T:T:T:T
T:T:T:T:T:T:T:T:T:T:T:T:T:T:T:T:T:T:T:T:T:T:T:T:T:T:T:T:T:T:T:T:T:T:T:T:T:T:T:T:T:T:T:T:T:T:T:T:T:T:T:T:T:T:T:T:T:T:T:T:T:T:T:T:T:T:T:T:T:T:T:T:T:T:T:T:T:T:T:T:T:T:T:T:T:T:T:T:T:T:T:T:T:T:T:T:T:T:T:T:T:T:T:T:T:T:T:T:T:T:T:T:T:T:T:T:T:T:T:T:T:T:T:T:T:T:T:T:T:T:T:T:T:T:T:T:T:T:T:T:T:T:T:T:T:T:T:T:T:T:T:T:T:T:T:T:T:T:T:T:T:T:T:T:T:T:T:T:T:T:T:T:T:T:T:T:T:T:T:T:T:T:T:T:T:T:T:T:T:T:T:T:T:T:T:T:T:T:T:T
T:T:T:T:T:T:T:T:T:T:T:T:T:T:T:T:T:T:T:T:T:T:T:T:T:T:T:T:T:T:T:T:T:T:T:T:T:T:T:T:T:T:T:T:T:T:T:T:T:T:T:T:T:T:T:T:T:T:T:T:T:T:T:T:T:T:T:T:T:T:T:T:T:T:T:T:T:T:T:T:T:T:T:T:T:T:T:T:T:T:T:T:T:T:T:T:T:T:T:T:T:T:T:T:T:T:T:T:T:T:T:T:T:T:T:T:T:T:T:T:T:T:T:T:T:T:T:T:T:T:T:T:T:T:T:T:T:T:T:T:T:T:T:T:T:T:T:T:T:T:T:T:T:T:T:T:T:T:T:T:T:T:T:T:T:T:T:T:T:T:T:T:T:T:T:T:T:T:T:T:T:T:T:T:T:T:T:T:T:T:T:T:T:T:T:T:T:T:T:T
T:T:T:T:T:T:T:T:T:T:T:T:T:T:T:T:T:T:T:T:T:T:T:T:T:T:T:T:T:T:T:T:T:T:T:T:T:T:T:T:T:T:T:T:T:T:T:T:T:T:T:T:T:T:T:T:T:T:T:T:T:T:T:T:T:T:T:T:T:T:T:T:T:T:T:T:T:T:T:T:T:T:T:T:T:T:T:T:T:T:T:T:T:T:T:T:T:T:T:T:T:T:T:T:T:T:T:T:T:T:T:T:T:T:T:T:T:T:T:T:T:T:T:T:T:T:T:T:T:T:T:T:T:T:T:T:T:T:T:T:T:T:T:T:T:T:T:T:T:T:T:T:T:T:T:T:T:T:T:T:T:T:T:T:T:T:T:T:T:T:T:T:T:T:T:T:T:T:T:A:A:A:T:T:T:T:T:T:T:T:T:T:T:T:T:T:T:T:T:T
T:T:P:T:T:P:P:T:T:T:T:T:T:T:T:T:T:T:T:T:T:T:T:T:T:T:T:T:T:T:T:T:T:T:T:T:T:T:T:T:T:T:T:T:T:T:T:P:P:P:T:T:T:T:T:T:T:T:T:T:P:T:T:T:T:T:T:T:T:T:T:T:T:T:T:T:T:T:T:T:T:T:T:T:T:T:T:T:T:T:T:T:T:T:T:T:T:T:T:T:T:T:T:T:T:T:T:T:T:T:T:T:T:T:T:T:T:T:T:T:T:T:T:T:T:T:T:T:T:T:T:T:T:T:T:T:T:T:T:T:T:T:T:T:T:T:T:T:T:T:T:T:T:T:T:T:T:T:T:T:T:T:T:T:T:T:T:T:T:T:T:T:P:P:P:T:T:T:A:A:A:A:A:T:T:T:T:T:T:T:T:T:T:T:T:T:T:T:T:T
P:P:P:P:P:P:P:P:P:P:P:P:P:P:P:P:T:T:T:T:T:T:T:T:P:P:P:P:P:P:R:P:P:P:P:P:P:T:T:T:T:T:P:P:P:P:P:P:P:P:P:P:P:P:P:P:P:P:P:P:P:P:P:P:P:P:P:P:P:P:P:P:P:P:P:P:P:P:P:T:T:T:T:P:P:P:T:T:T:T:T:T:T:T:T:T:T:T:T:T:T:T:T:P:P:P:P:P:P:P:P:P:P:P:P:P:P:P:P:P:T:T:T:T:T:T:T:P:P:P:P:P:P:P:T:T:T:T:T:T:T:T:P:P:P:P:P:P:P:P:T:T:T:P:P:P:P:P:P:T:T:T:T:T:P:P:P:P:P:P:P:P:P:P:P:P:P:P:A:P:P:P:P:T:T:T:T:T:T:P:P:P:P:P:P:T:T:T:T:T
P:P:P:P:P:P:P:P:P:P:P:P:P:P:P:P:P:P:P:P:P:T:T:T:P:P:P:P:P:P:P:P:P:P:P:P:P:P:P:P:P:P:P:P:P:P:P:P:P:P:P:P:P:P:P:P:P:P:P:P:P:P:P:P:F:P:P:P:P:P:P:P:P:P:P:P:P:P:P:P:T:T:P:P:P:P:P:T:T:T:T:T:T:P:P:P:P:T:T:T:P:P:P:P:P:P:P:P:P:P:P:P:P:P:P:P:P:P:P:P:P:P:P:T:T:P:P:P:P:P:P:P:P:P:P:T:T:T:T:P:P:P:P:P:P:P:P:P:P:P:P:T:P:P:P:P:P:P:P:P:P:P:T:P:P:P:P:P:P:P:P:P:P:P:P:P:P:A:A:P:P:P:P:P:P:P:T:T:T:P:P:P:P:P:P:P:T:T:T:P
P:P:P:P:R:P:P:P:P:P:P:P:P:P:P:P:P:P:P:P:P:P:P:T:P:P:P:P:P:P:P:P:P:P:R:P:P:P:P:P:P:P:P:P:P:P:P:P:D:P:P:P:P:P:P:P:P:P:P:P:P:P:P:P:P:P:P:P:P:P:P:P:P:P:P:P:P:P:P:P:T:P:P:P:P:P:P:P:P:P:P:P:P:P:P:P:P:R:T:T:P:P:P:P:P:P:P:P:P:P:P:P:P:P:P:P:P:P:P:P:P:P:P:T:T:P:P:P:P:P:P:P:P:P:P:P:P:P:T:P:P:P:P:P:P:I:P:P:P:P:P:T:P:P:P:P:P:P:P:P:P:P:T:P:P:P:P:P:P:P:P:P:P:P:P:P:A:A:P:P:P:P:P:P:P:P:P:P:P:P:P:P:P:P:P:P:P:T:P:P
P:P:P:P:P:P:P:P:P:P:P:P:P:P:P:P:P:P:P:P:P:P:P:P:P:P:P:P:P:P:P:P:P:P:P:P:P:P:P:P:P:P:P:P:P:P:P:P:P:P:P:P:P:P:P:P:P:P:P:P:P:P:P:P:P:P:P:P:P:P:P:P:F:F:P:P:P:P:P:P:P:P:P:P:P:P:P:P:P:P:P:P:P:P:P:P:P:P:P:P:P:P:P:P:P:P:P:P:P:P:F:P:P:P:P:P:P:P:P:P:P:P:P:P:P:P:P:P:P:P:P:P:P:P:P:P:P:P:P:P:P:P:P:P:P:P:P:P:P:P:P:P:P:P:P:P:P:P:P:P:P:P:P:P:F:P:P:P:P:F:P:P:P:P:P:P:A:P:P:P:P:P:P:P:P:P:P:P:P:P:P:P:P:P:P:P:P:T:P:P
P:P:P:P:P:P:P:P:P:P:P:P:P:P:P:D:P:P:P:P:P:P:P:P:P:P:P:P:P:P:P:P:P:P:P:P:P:P:P:P:P:P:P:P:P:P:P:P:P:P:P:P:P:P:P:P:P:P:P:P:P:P:P:P:P:P:P:P:P:P:P:P:P:P:P:P:P:P:P:P:P:P:P:P:P:P:P:P:P:P:P:P:P:P:P:P:P:P:P:P:P:P:P:P:P:P:P:P:P:P:P:P:P:P:P:P:P:P:P:P:P:P:P:P:P:P:P:P:F:P:P:P:P:P:P:P:P:P:P:P:P:P:P:P:P:P:P:P:P:P:P:P:P:P:P:P:P:P:P:P:P:P:P:P:F:P:P:P:P:P:P:P:P:P:P:A:A:P:P:R:P:P:P:P:P:P:P:P:P:P:P:R:P:P:P:P:P:P:P:P
P:P:P:P:P:P:P:P:P:P:P:P:P:P:P:P:P:P:P:P:P:P:P:P:R:P:P:P:P:P:P:P:P:P:P:P:P:R:P:P:P:P:P:P:P:P:P:P:P:P:P:P:P:P:P:P:P:P:P:P:P:P:P:P:P:P:P:P:P:P:P:P:P:P:P:P:P:P:P:P:P:P:P:P:P:P:P:P:P:P:P:P:P:P:P:P:P:P:P:P:P:P:P:P:P:P:P:P:P:P:P:P:P:P:P:P:P:R:R:P:P:P:P:P:P:P:P:P:P:P:P:P:P:P:P:P:P:P:P:P:P:P:P:P:P:P:P:P:P:P:P:P:P:P:P:P:P:P:P:P:P:P:P:P:P:P:P:P:P:P:P:P:P:P:A:A:P:P:P:P:P:P:P:P:P:P:P:P:P:P:P:P:P:P:P:P:P:P:P:P
P:P:P:P:P:P:P:P:P:P:P:P:P:P:P:P:P:P:P:R:P:P:P:P:P:P:P:P:P:P:P:P:P:P:P:P:P:P:P:P:P:P:P:P:P:P:P:P:P:P:P:P:P:P:F:F:P:P:P:P:P:P:P:P:P:P:P:P:P:P:P:P:P:P:P:P:P:P:P:P:P:P:R:P:P:S:S:S:S:P:P:P:P:P:P:P:P:P:P:P:P:R:P:P:P:P:P:P:P:P:P:P:P:P:P:P:P:P:P:P:P:R:P:P:P:P:P:P:P:P:P:P:P:P:P:P:P:P:P:P:P:P:P:P:P:P:P:P:P:P:P:P:P:P:D:R:F:P:P:P:P:P:P:P:P:P:P:P:P:P:P:P:P:A:A:P:P:P:P:P:P:P:P:P:P:P:P:P:P:P:P:P:P:P:P:P:P:P:P:P
P:P:P:P:P:P:P:P:P:P:P:P:P:P:P:P:P:P:P:P:P:P:P:P:P:P:P:P:P:P:P:P:P:P:P:P:P:P:P:P:P:P:P:P:P:P:P:P:P:P:P:P:P:P:F:F:P:P:P:P:P:P:P:P:P:P:P:P:P:P:P:P:P:P:P:P:P:P:P:F:F:A:A:S:S:S:S:S:S:P:P:P:P:P:P:P:P:P:P:P:P:P:P:P:P:P:P:P:P:P:P:P:P:P:P:P:P:P:P:P:P:P:P:P:P:P:P:P:P:P:P:P:P:P:P:F:P:P:P:P:P:P:P:P:P:P:P:P:P:P:P:P:P:P:R:R:F:P:P:P:P:P:P:P:P:P:P:P:P:P:P:P:P:A:P:P:P:P:P:P:P:P:P:P:P:P:P:P:P:P:P:P:P:P:P:P:P:P:P:P
P:P:P:P:P:P:P:P:P:P:P:P:P:P:P:P:P:P:P:P:P:P:P:P:P:P:P:P:P:P:P:P:P:P:P:P:P:P:P:P:P:P:P:P:P:P:P:P:P:P:P:P:P:P:P:P:P:P:P:P:P:P:P:P:P:P:P:P:P:P:P:D:P:P:P:P:P:P:P:F:A:A:A:P:S:S:S:S:P:P:P:P:P:P:P:P:P:P:P:P:P:P:P:P:P:P:P:P:P:P:P:P:P:P:P:P:P:P:P:P:P:P:P:P:P:P:P:P:P:P:P:P:P:P:P:P:P:P:P:P:P:P:P:P:P:P:P:P:P:P:P:P:P:P:R:F:F:P:P:P:P:P:P:P:P:P:P:P:P:A:A:A:A:A:P:P:P:P:P:P:P:P:P:P:P:P:P:P:P:P:P:P:P:P:P:P:P:P:P:P
P:P:P:P:P:P:P:P:P:P:P:P:P:P:P:P:P:P:P:P:P:P:P:P:P:P:P:P:P:P:P:P:P:F:F:F:P:P:P:P:P:P:P:P:P:P:P:P:P:P:P:P:P:P:P:P:P:P:P:P:P:P:P:P:P:P:F:P:P:P:P:P:P:P:P:P:P:A:A:A:A:A:P:P:P:P:S:S:P:P:P:P:P:P:P:P:P:P:P:P:P:P:P:P:P:P:P:P:P:P:P:P:P:P:P:P:P:P:P:P:P:P:P:P:P:P:P:P:P:F:P:P:P:P:P:P:P:P:P:P:P:P:P:P:P:P:P:P:P:P:P:P:P:P:P:P:P:P:P:P:P:F:P:P:P:P:A:A:A:A:P:P:P:P:P:P:P:P:P:P:P:P:P:P:P:P:P:P:P:P:P:P:P:P:P:P:P:P:P:P
P:P:P:P:P:P:P:P:P:P:P:P:P:P:P:P:P:P:P:P:P:P:P:P:P:P:P:P:P:P:P:P:P:P:P:P:P:P:P:P:P:P:P:P:P:P:P:P:P:P:P:P:P:P:P:P:P:P:P:P:P:P:P:P:P:P:P:P:P:P:P:P:P:R:R:P:R:A:A:A:A:A:P:P:P:P:P:P:P:P:P:P:P:P:P:P:P:P:P:P:P:P:D:P:P:P:P:P:P:P:P:P:P:P:D:P:P:P:P:P:P:P:P:P:P:P:P:P:P:P:P:P:P:P:P:P:P:P:P:P:P:P:P:P:P:P:P:P:P:P:P:P:P:P:P:P:P:P:P:P:P:P:A:A:A:A:A:P:P:P:P:P:P:P:P:P:P:P:P:P:P:P:P:P:P:P:P:P:P:P:P:P:P:P:P:P:P:P:P:P
P:P:P:P:P:P:P:P:P:P:P:P:P:P:P:P:P:P:P:P:P:P:P:P:P:P:P:P:P:P:P:P:P:P:P:P:P:P:P:P:P:P:P:P:P:P:P:P:P:P:P:P:P:P:P:P:P:P:P:P:P:P:P:P:P:P:P:P:P:P:P:P:P:P:P:P:A:A:A:A:P:P:P:P:P:P:P:P:P:P:P:P:P:P:P:P:P:P:P:P:P:P:P:P:P:P:P:P:P:P:P:P:P:P:P:P:P:P:P:P:R:P:P:P:P:P:P:P:P:P:P:P:P:P:P:P:P:P:P:P:P:P:P:P:P:P:D:P:P:P:P:P:P:P:P:P:P:A:A:A:A:A:A:A:A:P:P:P:P:P:P:P:P:P:P:P:P:P:P:P:P:P:P:P:P:P:P:P:P:P:P:P:P:P:P:P:P:P:P:P
P:P:P:P:P:P:P:P:P:P:P:P:P:P:P:P:P:P:P:P:P:P:P:P:P:P:P:P:P:P:P:P:P:P:P:P:P:P:P:P:P:P:P:P:P:P:P:P:P:P:P:P:P:P:P:P:P:P:P:P:P:P:P:P:P:P:P:P:P:P:P:P:P:P:P:A:A:A:A:A:P:P:P:P:P:P:P:P:P:P:P:P:P:P:P:P:P:P:P:P:P:P:P:P:P:P:P:P:P:P:P:P:P:P:P:P:P:P:P:P:P:P:P:P:P:P:P:P:P:P:P:P:P:P:P:P:P:P:P:P:P:P:P:P:P:P:P:P:P:P:P:P:P:P:D:D:A:A:A:P:P:P:P:P:P:P:P:P:P:P:P:P:P:P:P:P:P:P:P:P:P:P:P:P:P:P:P:P:P:P:P:P:P:P:P:P:P:P:P:P
P:P:P:P:F:F:P:P:P:P:D:P:P:P:P:P:P:P:R:P:P:P:P:P:P:P:P:P:P:P:P:P:P:P:P:P:P:P:P:P:P:P:D:D:P:P:P:P:P:P:P:P:P:P:P:P:P:P:P:P:P:D:P:P:P:P:P:P:P:P:P:A:A:A:A:A:A:A:A:I:P:P:P:P:P:P:P:P:P:P:P:P:P:P:P:P:P:P:P:P:P:P:P:P:P:P:P:P:P:P:P:P:P:P:P:P:P:P:P:P:P:P:P:P:P:P:P:P:P:P:P:P:P:P:P:P:P:P:P:P:P:P:P:P:P:P:P:P:P:P:P:P:P:D:D:D:P:P:P:P:P:P:P:P:P:P:P:P:P:P:P:P:P:P:P:P:P:P:P:P:P:P:P:P:P:P:P:P:P:P:P:P:P:P:P:P:P:P:P:P
P:P:P:F:F:F:F:P:P:P:P:P:P:P:P:P:P:P:R:P:P:P:P:P:P:P:P:P:P:P:P:P:P:P:R:P:P:P:P:P:P:P:P:P:P:P:P:P:P:P:P:P:P:P:P:P:P:P:P:P:P:P:P:P:P:P:P:P:P:F:F:F:A:A:A:A:A:A:P:P:P:P:P:P:P:P:P:P:P:P:P:P:P:P:P:P:P:P:P:P:P:P:P:P:F:P:P:P:P:P:P:P:P:P:P:P:P:P:P:P:P:P:P:P:P:P:P:P:P:P:P:P:P:P:P:P:P:P:P:P:P:P:P:P:P:P:P:P:P:P:P:P:P:P:P:P:P:P:P:P:P:P:P:P:P:P:P:P:P:P:P:P:P:P:P:P:P:P:P:P:P:P:P:P:P:P:P:P:P:P:R:P:P:P:P:P:P:P:P:P
P:P:F:F:R:R:F:P:P:P:P:P:P:P:P:P:P:R:R:P:P:P:P:P:P:P:A:P:R:P:P:P:P:P:R:P:P:P:P:P:P:P:P:P:P:P:P:P:P:P:P:P:P:P:P:P:P:P:P:P:P:P:P:P:P:P:P:P:P:P:P:P:P:P:P:F:F:F:P:P:P:P:P:P:P:P:P:P:P:P:P:P:P:P:P:P:P:P:P:P:P:P:P:P:P:P:P:P:P:P:P:P:P:P:P:P:P:P:P:P:P:P:P:P:P:P:P:P:F:F:F:P:P:P:P:P:P:P:P:P:P:P:P:P:P:P:P:P:P:P:P:P:P:P:P:P:P:P:P:P:P:P:F:P:P:P:P:P:P:P:P:P:P:P:P:P:P:P:P:P:P:P:P:P:P:P:P:P:P:P:P:P:P:P:P:P:P:P:P:P
P:P:F:F:R:R:F:F:P:P:P:P:P:P:P:P:P:P:P:P:P:P:A:A:A:A:A:P:P:P:P:P:P:P:P:P:P:P:P:P:P:P:P:P:P:P:P:P:P:P:P:P:P:P:P:P:P:P:P:P:P:P:P:P:P:P:P:P:P:P:P:P:P:P:P:P:P:R:R:P:P:P:P:P:P:P:P:P:P:P:P:P:P:P:F:P:P:P:P:P:P:P:P:P:P:P:P:P:P:P:P:P:P:R:P:P:P:P:P:P:P:P:P:P:P:P:P:P:F:F:F:P:P:P:P:P:P:P:P:P:P:P:P:P:P:P:P:P:P:P:P:P:P:P:P:P:P:P:P:P:P:P:P:P:P:P:P:P:P:P:P:P:R:P:P:P:P:P:P:P:P:P:P:P:P:P:P:P:P:P:P:P:P:P:P:P:P:P:P:P
P:P:P:R:R:R:R:P:P:P:P:P:P:P:P:P:P:P:P:P:P:A:A:A:A:A:A:P:P:P:P:R:P:P:P:P:P:P:P:P:P:P:P:P:P:P:P:P:P:P:P:P:P:P:P:P:P:P:P:P:P:P:P:P:P:P:R:P:P:P:P:P:P:P:P:P:P:P:P:P:P:P:P:P:P:P:P:P:P:P:P:P:P:P:F:F:P:P:P:P:P:P:P:P:P:P:P:P:P:P:P:P:R:R:P:R:P:P:P:P:P:P:P:P:P:P:P:P:F:R:P:P:P:P:P:P:P:P:P:P:P:P:P:P:P:P:P:P:P:P:P:P:P:P:P:P:P:P:P:P:P:P:P:P:P:P:P:P:P:P:P:P:P:P:P:P:P:P:P:P:P:P:P:P:P:P:P:P:P:P:P:P:P:P:P:P:P:P:P:P
P:P:P:R:I:R:R:P:P:P:P:P:P:P:P:P:P:P:P:P:A:A:A:A:A:A:A:P:P:P:P:P:P:P:P:P:P:P:P:P:P:P:P:P:P:P:P:P:P:P:P:P:P:P:P:P:P:P:P:P:P:P:P:P:P:P:P:P:P:P:P:P:P:P:P:P:P:P:P:P:P:P:P:P:P:P:P:P:P:P:P:P:P:P:F:F:F:P:P:P:P:P:P:P:P:P:P:P:P:P:P:P:R:R:R:R:P:P:P:P:P:P:P:P:P:P:P:P:F:P:P:P:P:P:P:P:P:P:P:P:P:P:F:P:P:P:P:P:P:P:P:P:F:P:P:P:P:P:P:P:P:P:P:P:P:P:P:P:P:P:P:P:P:P:P:P:P:P:P:P:P:P:P:P:P:P:P:P:P:P:P:P:P:P:P:P:P:P:P:P
P:P:P:R:R:R:R:P:P:P:P:P:P:P:P:P:P:P:P:P:P:D:I:D:A:P:P:P:P:P:P:P:P:P:P:P:P:P:P:P:P:P:P:P:P:P:P:P:P:P:P:F:F:F:P:P:P:P:P:P:R:P:P:P:P:P:P:P:P:P:P:P:P:P:P:P:P:P:P:P:P:P:R:P:P:P:P:P:P:P:P:P:P:P:P:P:P:P:P:P:P:P:P:P:P:P:P:P:P:P:P:P:P:P:R:P:P:P:P:P:P:P:P:P:P:P:P:P:P:P:P:P:P:P:P:P:R:P:P:P:P:P:P:P:P:P:P:P:P:P:P:P:P:P:P:P:P:P:P:P:P:P:P:P:P:P:P:P:P:P:P:P:P:P:P:P:P:P:P:P:P:P:P:P:P:P:P:P:P:P:P:P:P:P:P:P:P:P:P:P
P:P:P:P:P:P:P:P:P:P:P:P:P:P:P:P:P:P:P:P:P:P:P:P:P:P:P:P:P:P:P:P:P:P:P:P:P:P:P:P:P:P:P:P:P:P:P:P:P:P:P:F:P:P:P:P:P:P:P:P:P:P:P:P:P:P:P:P:P:P:R:P:P:P:P:P:P:P:P:P:P:P:P:P:P:P:P:P:P:P:P:P:P:P:P:P:P:P:P:P:P:P:P:P:P:P:P:P:P:P:P:P:P:P:P:P:P:P:P:P:P:P:P:P:P:P:P:P:P:P:P:P:P:P:P:P:P:P:P:P:P:P:P:P:P:P:P:P:P:P:P:P:P:P:P:P:P:P:P:P:P:P:P:P:P:F:P:P:P:P:P:P:P:P:P:P:P:P:P:P:P:P:P:P:P:P:P:P:P:P:P:P:P:P:P:P:P:P:P:P
P:P:P:P:P:P:P:P:P:P:P:P:P:P:P:P:P:P:P:P:P:P:P:P:P:P:P:P:P:P:P:P:P:P:P:P:P:P:P:P:P:P:P:P:P:P:P:P:P:P:P:P:P:P:P:P:P:P:P:P:P:P:P:P:P:P:P:P:P:P:P:P:P:P:P:P:P:P:P:P:P:P:P:P:P:P:P:P:P:P:P:P:P:P:P:P:P:P:P:P:P:P:P:P:P:P:P:P:P:P:P:P:P:P:P:P:P:P:P:P:P:P:P:P:P:P:P:P:P:P:P:P:P:P:P:P:P:P:P:P:P:P:P:P:P:P:P:P:P:P:P:P:P:P:P:P:P:P:P:P:P:P:P:P:P:P:P:P:P:P:P:P:P:P:P:P:P:P:P:P:P:P:P:P:P:P:P:P:P:P:P:P:P:P:P:P:P:P:P:P
