A:A:A:A:A:A:A:A:A:A:A:A:A:A:A:A:A:A:A:A:A:A:A:A:A:A:A:A:A:A:A:A:A:A:A:A:A:A:A:A:A:A:A:A:A:A:A:A:A:A:A:A:A:A
A:T:A:T:A:A:A:T:A:T:A:T:A:T:A:T:A:T:A:T:A:T:A:T:A:T:A:T:A:T:A:T:A:T:A:T:A:T:A:T:A:T:A:T:A:T:A:T:A:T:A:T:T:A
A:T:A:T:A:A:A:A:A:A:A:A:A:A:A:A:A:A:A:A:A:A:A:A:A:A:A:A:A:A:A:A:A:A:A:A:A:A:A:A:A:A:A:A:A:A:A:A:A:A:A:A:T:A
A:T:A:A:A:A:A:A:A:A:A:A:A:A:A:A:A:A:A:A:A:A:A:A:A:A:A:A:A:A:A:A:A:A:A:A:A:A:A:A:A:A:A:A:A:A:A:A:A:A:A:A:T:A
A:T:T:T:T:T:T:T:T:A:A:A:A:A:A:A:A:A:A:A:A:A:A:A:A:A:A:A:A:A:A:A:A:A:A:A:A:A:A:A:A:A:A:A:A:A:A:A:A:A:A:A:T:A
A:T:A:A:A:A:A:A:A:T:A:A:A:A:A:A:A:A:A:A:A:A:A:A:A:A:A:A:A:A:A:A:A:A:A:A:A:A:A:A:A:A:A:A:A:A:A:A:A:A:A:A:T:A
A:T:A:A:A:A:A:A:A:A:T:A:A:A:A:A:A:A:A:A:A:A:A:A:A:A:A:A:A:A:A:A:A:A:A:A:A:A:A:A:A:A:A:A:A:A:A:A:A:A:A:A:T:A
A:T:A:A:A:A:A:A:A:A:A:T:A:A:A:A:A:A:A:A:A:A:A:A:A:A:A:A:A:A:A:A:A:A:A:A:A:A:A:A:A:A:A:A:A:A:A:A:A:A:A:A:T:A
A:T:A:A:A:A:A:A:A:A:A:A:T:A:A:A:A:A:A:A:A:A:A:A:A:A:A:A:A:A:A:A:A:A:A:A:A:A:A:A:A:A:A:A:A:A:A:A:A:A:A:A:T:A
A:T:A:A:A:A:A:A:A:A:A:A:A:T:A:A:A:A:A:A:A:A:A:A:A:A:A:A:A:A:A:A:A:A:A:A:A:A:A:A:A:A:A:A:A:A:A:A:A:A:A:A:T:A
A:T:A:A:A:A:A:A:A:T:T:T:T:T:T:A:A:A:A:A:A:A:A:A:A:A:A:A:A:A:A:A:A:A:A:A:A:A:A:A:A:A:A:A:A:A:A:A:A:A:A:A:T:A
A:T:A:A:A:A:A:A:A:A:A:A:A:A:A:T:A:A:A:A:A:A:A:A:A:A:A:A:A:A:A:A:A:A:A:A:A:A:A:A:A:A:A:A:A:A:A:A:A:A:A:A:T:A
A:T:A:A:A:A:A:A:A:A:A:A:A:A:A:A:T:A:A:A:A:A:A:A:A:A:A:A:A:A:A:A:A:A:A:A:A:A:A:A:A:A:A:A:A:A:A:A:A:A:A:A:T:A
A:T:A:A:A:A:A:A:A:A:A:A:A:A:A:A:A:T:A:A:A:A:A:A:A:A:A:A:A:A:A:A:A:A:A:A:A:A:A:A:A:A:A:A:A:A:A:A:A:A:A:A:T:A
A:T:A:A:A:A:A:A:A:A:A:A:A:A:A:A:A:A:T:A:A:A:A:A:A:A:A:A:A:A:A:A:A:A:A:A:A:A:A:A:A:A:A:A:A:A:A:A:A:A:A:A:T:A
A:T:A:A:A:A:A:A:A:A:A:A:A:A:A:A:A:A:A:T:A:A:A:A:A:A:A:A:A:A:A:A:A:A:A:A:A:A:A:A:A:A:A:A:A:A:A:A:A:A:A:A:T:A
A:T:A:A:A:A:A:A:A:A:A:A:A:A:A:A:A:A:A:A:A:A:A:A:A:A:A:A:A:A:A:A:A:A:A:A:A:A:A:A:A:A:A:A:A:A:A:A:A:A:A:A:T:A
A:T:A:A:A:A:A:A:A:A:A:A:A:A:A:A:A:A:A:A:T:A:A:A:A:A:A:A:A:A:A:A:A:A:A:A:A:A:A:A:A:A:A:A:A:A:A:A:A:A:A:A:T:A
A:T:A:A:A:A:A:A:A:A:A:A:A:A:A:A:A:A:A:A:A:T:A:A:A:A:A:A:A:A:A:A:A:A:A:A:A:A:A:A:A:A:A:A:A:A:A:A:A:A:A:A:T:A
A:T:A:A:A:A:A:A:A:A:A:A:A:A:A:A:A:A:A:A:A:A:T:A:A:A:A:A:A:A:A:A:A:A:A:A:A:A:A:A:A:A:A:A:A:A:A:A:A:A:A:A:T:A
A:T:A:A:A:A:A:A:A:A:A:A:A:A:A:A:A:A:A:A:A:A:A:T:A:A:A:A:A:A:A:A:A:A:A:A:A:A:A:A:A:A:A:A:A:A:A:A:A:A:A:A:T:A
A:T:A:A:A:A:A:A:A:A:A:A:A:A:A:A:A:A:A:A:A:A:A:A:T:A:A:A:A:A:A:A:A:A:A:A:A:A:A:A:A:A:A:A:A:A:A:A:A:A:A:A:T:A
A:T:A:A:A:A:A:A:A:A:A:A:A:A:A:A:A:A:A:A:A:A:A:A:A:A:A:A:A:A:A:A:A:A:A:A:A:A:A:A:A:A:A:A:A:A:A:A:A:A:A:A:T:A
A:T:A:A:A:A:A:A:A:A:A:A:A:A:A:A:A:A:A:A:A:A:A:A:A:T:A:A:A:A:A:A:A:A:A:A:A:A:A:A:A:A:A:A:A:A:A:A:A:A:A:A:T:A
A:T:A:A:A:A:A:A:A:A:A:A:A:A:A:A:A:A:A:A:A:A:A:A:A:A:A:A:A:A:A:A:A:A:A:A:A:A:A:A:A:A:A:A:A:A:A:A:A:A:A:A:T:A
A:T:A:A:A:A:A:A:A:A:A:A:A:A:A:A:A:A:A:A:A:A:A:A:A:A:T:A:A:A:A:A:A:A:A:A:A:A:A:A:A:A:A:A:A:A:A:A:A:A:A:A:T:A
A:T:A:A:A:A:A:A:A:A:A:A:A:A:A:A:A:A:A:A:A:A:A:A:A:A:A:T:A:A:A:A:A:A:A:A:A:A:A:A:A:A:A:A:A:A:A:A:A:A:A:A:T:A
A:T:A:A:A:A:A:A:A:A:A:A:A:A:A:A:A:A:A:A:A:A:A:A:A:A:A:A:T:A:A:A:A:A:A:A:A:A:A:A:A:A:A:A:A:A:A:A:A:A:A:A:T:A
A:T:A:A:A:A:A:A:A:A:A:A:A:A:A:A:A:A:A:A:A:A:A:A:A:A:A:A:A:A:A:A:A:A:A:A:A:A:A:A:A:A:A:A:A:A:A:A:A:A:A:A:T:A
A:T:A:A:A:A:A:A:A:A:A:A:A:A:A:A:A:A:A:A:A:A:A:A:A:A:A:A:A:T:T:A:A:A:A:A:A:A:A:A:A:A:A:A:A:A:A:A:A:A:A:A:T:A
A:T:A:A:A:A:A:A:A:A:A:A:A:A:A:A:A:A:A:A:A:A:A:A:A:A:A:A:A:T:T:A:A:A:A:A:A:A:A:A:A:A:A:A:A:A:A:A:A:A:A:A:T:A
A:T:A:A:A:A:A:A:A:A:A:A:A:A:A:A:A:A:A:A:A:A:A:A:A:A:A:A:A:T:T:A:A:A:A:A:A:A:A:A:A:A:A:A:A:A:A:A:A:A:A:A:T:A
A:T:A:A:A:A:A:A:A:A:A:A:A:A:A:A:A:A:A:A:A:A:A:A:A:A:A:A:A:T:T:A:A:A:A:A:A:A:A:A:A:A:A:A:A:A:A:A:A:A:A:A:T:A
A:T:A:A:A:A:A:A:A:A:A:A:A:A:A:A:A:A:A:A:A:A:A:A:A:A:A:A:A:T:T:A:A:A:A:A:A:A:A:A:A:A:A:A:A:A:A:A:A:A:A:A:T:A
A:T:A:A:A:A:A:A:A:A:A:A:A:A:A:A:A:A:A:A:A:A:A:A:A:A:A:A:A:T:T:A:A:A:A:A:A:A:A:A:A:A:A:A:A:A:A:A:A:A:A:A:T:A
A:T:A:A:A:A:A:A:A:A:A:A:A:A:A:A:A:A:A:A:A:A:A:A:A:A:A:A:A:T:T:A:A:A:A:A:A:A:A:A:A:A:A:A:A:A:A:A:A:A:A:A:T:A
A:T:A:A:A:A:A:A:A:A:A:A:A:A:A:A:A:A:A:A:A:A:A:A:A:A:A:A:A:T:T:A:A:A:A:A:A:A:A:A:A:A:A:A:A:A:A:A:A:A:A:A:T:A
A:T:A:A:A:A:A:A:A:A:A:A:A:A:A:A:A:A:A:A:A:A:A:A:A:A:A:A:A:T:T:A:A:A:A:A:A:A:A:A:A:A:A:A:A:A:A:A:A:A:A:A:T:A
A:T:A:A:A:A:A:A:A:A:A:A:A:A:A:A:A:A:A:A:A:A:A:A:A:A:A:A:A:T:T:A:A:A:A:A:A:A:A:A:A:A:A:A:A:A:A:A:A:A:A:A:T:A
A:T:A:A:A:A:A:A:A:A:A:A:A:A:A:A:A:A:A:A:A:A:A:A:A:A:A:A:A:T:T:A:A:A:A:A:A:A:A:A:A:A:A:A:A:A:A:A:A:A:A:A:T:A
A:T:A:A:A:A:A:A:A:A:A:A:A:A:A:A:A:A:A:A:A:A:A:A:A:A:A:A:A:T:T:A:A:A:A:A:A:A:A:A:A:A:A:A:A:A:A:A:A:A:A:A:T:A
A:T:A:A:A:A:A:A:A:A:A:A:A:A:A:A:A:A:A:A:A:A:A:A:A:A:A:A:A:T:T:A:A:A:A:A:A:A:A:A:A:A:A:A:A:A:A:A:A:A:A:A:T:A
A:T:A:A:A:A:A:A:A:A:A:A:A:A:A:A:A:A:A:A:A:A:A:A:A:A:A:A:A:T:T:A:A:A:A:A:A:A:A:A:A:A:A:A:A:A:A:A:A:A:A:A:T:A
A:T:A:A:A:A:A:A:A:A:A:A:A:A:A:A:A:A:A:A:A:A:A:A:A:A:A:A:A:T:T:A:A:A:A:A:A:A:A:A:A:A:A:A:A:A:A:A:A:A:A:A:T:A
A:T:A:A:A:A:A:A:A:A:A:A:A:A:A:A:A:A:A:A:A:A:A:A:A:A:A:A:A:T:T:A:A:A:A:A:A:A:A:A:A:A:A:A:A:A:A:A:A:A:A:A:T:A
A:T:A:A:A:A:A:A:A:A:A:A:A:A:A:A:A:A:A:A:A:A:A:A:A:A:A:A:A:T:T:A:A:A:A:A:A:A:A:A:A:A:A:A:A:A:A:A:A:A:A:A:T:A
A:T:A:A:A:A:A:A:A:A:A:A:A:A:A:A:A:A:A:A:A:A:A:A:A:A:A:A:A:T:T:A:A:A:A:A:A:A:A:A:A:A:A:A:A:A:A:A:A:A:A:A:T:A
A:T:A:A:A:A:A:A:A:A:A:A:A:A:A:A:A:A:A:A:A:A:A:A:A:A:A:A:A:T:T:A:A:A:A:A:A:A:A:A:A:A:A:A:A:A:A:A:A:A:A:A:T:A
A:T:A:A:A:A:A:A:A:A:A:A:A:A:A:A:A:A:A:A:A:A:A:A:A:A:A:A:A:T:T:A:A:A:A:A:A:A:A:A:A:A:A:A:A:A:A:A:A:A:A:A:T:A
A:T:A:A:A:A:A:A:A:A:A:A:A:A:A:A:A:A:A:A:A:A:A:A:A:A:A:A:A:A:A:A:A:A:A:A:A:A:A:A:A:A:A:A:A:A:A:A:A:A:A:A:T:A
A:T:A:A:A:A:A:A:A:A:A:A:A:A:A:A:A:A:A:A:A:A:A:A:A:A:A:A:A:A:A:A:A:A:A:A:A:A:A:A:A:A:A:A:A:A:A:A:A:A:A:A:T:A
A:T:A:A:A:A:A:A:A:A:A:A:A:A:A:A:A:A:A:A:A:A:A:A:A:A:A:A:A:A:A:A:A:A:A:A:A:A:A:A:A:A:A:A:A:A:A:A:A:A:A:A:T:A
A:T:T:T:T:T:T:T:T:T:T:T:T:T:T:T:T:T:T:T:T:T:T:T:T:T:T:T:T:T:T:T:T:T:T:T:T:T:T:T:T:T:T:T:T:T:T:T:T:T:T:T:T:A
A:A:A:A:A:A:A:A:A:A:A:A:A:A:A:A:A:A:A:A:A:A:A:A:A:A:A:A:A:A:A:A:A:A:A:A:A:A:A:A:A:A:A:A:A:A:A:A:A:A:A:A:A:A
