I:I:I:I:I:I:I:I:I:I:I:I:I:I:I:I:I:I:I:I:I:I:I:I:I:I:I:I:I:I:I:I:I:I:I:I:I:I:I:I:I:I:I:I:I:I:I:I:I:I:I:I:I:I
I:T:A:T:A:T:A:T:A:T:A:T:A:T:A:T:A:T:A:T:A:T:A:T:A:T:A:T:A:T:A:T:A:T:A:T:A:T:A:T:A:T:A:T:A:T:A:T:A:T:A:T:T:I
I:T:A:T:A:A:A:A:A:A:A:A:A:A:A:A:A:A:A:A:A:A:A:A:A:A:A:A:A:A:A:A:A:A:A:A:A:A:A:A:A:A:A:A:A:A:A:A:A:A:A:A:T:I
I:T:A:A:A:A:A:A:A:A:A:A:A:A:A:A:A:A:A:A:A:A:A:A:A:A:A:A:A:A:A:A:A:A:A:A:A:A:A:A:A:A:A:A:A:A:A:A:A:A:A:A:T:I
I:T:T:T:T:T:T:T:A:A:A:A:A:A:A:A:A:A:A:A:A:A:A:A:A:A:A:A:A:A:A:A:A:A:A:A:A:A:A:A:A:A:A:A:A:A:A:A:A:A:A:A:T:I
I:T:A:A:A:A:A:A:A:A:A:A:A:A:A:A:A:A:A:A:A:A:A:A:A:A:A:A:A:A:A:A:A:A:A:A:A:A:A:A:A:A:A:A:A:A:A:A:A:A:A:A:T:I
I:T:A:A:A:A:A:A:A:A:A:A:A:A:A:A:A:A:A:A:A:A:A:A:A:A:A:A:A:A:A:A:A:A:A:A:A:A:A:A:A:A:A:A:A:A:A:A:A:A:A:A:T:I
I:T:A:A:A:A:A:A:A:A:A:A:A:A:A:A:A:A:A:A:A:A:A:A:A:A:A:A:A:A:A:A:A:A:A:A:A:A:A:A:A:A:A:A:A:A:A:A:A:A:A:A:T:I
I:T:A:A:A:A:A:A:A:A:A:A:A:A:A:A:A:A:A:A:A:A:A:A:A:A:A:A:A:A:A:A:A:A:A:A:A:A:A:A:A:A:A:A:A:A:A:A:A:A:A:A:T:I
I:T:A:A:A:A:A:A:A:A:A:A:A:A:A:A:A:A:A:A:A:A:A:A:A:A:A:A:A:A:A:A:A:A:A:A:A:A:A:A:A:A:A:A:A:A:A:A:A:A:A:A:T:I
I:T:A:A:A:A:A:A:A:T:T:T:T:T:T:A:A:A:A:A:A:A:A:A:A:A:A:A:A:A:A:A:A:A:A:A:A:A:A:A:A:A:A:A:A:A:A:A:A:A:A:A:T:I
I:T:A:A:A:A:A:A:A:A:A:A:A:A:A:T:A:A:A:A:A:A:A:A:A:A:A:A:A:A:A:A:A:A:A:A:A:A:A:A:A:A:A:A:A:A:A:A:A:A:A:A:T:I
I:T:A:A:A:A:A:A:A:A:A:A:A:A:A:A:T:A:A:A:A:A:A:A:A:A:A:A:A:A:A:A:A:A:A:A:A:A:A:A:A:A:A:A:A:A:A:A:A:A:A:A:T:I
I:T:A:A:A:A:A:A:A:A:A:A:A:A:A:A:A:T:A:A:A:A:A:A:A:A:A:A:A:A:A:A:A:A:A:A:A:A:A:A:A:A:A:A:A:A:A:A:A:A:A:A:T:I
I:T:A:A:A:A:A:A:A:A:A:A:A:A:A:A:A:A:T:A:A:A:A:A:A:A:A:A:A:A:A:A:A:A:A:A:A:A:A:A:A:A:A:A:A:A:A:A:A:A:A:A:T:I
I:T:A:A:A:A:A:A:A:A:A:A:A:A:A:A:A:A:A:T:A:A:A:A:A:A:A:A:A:A:A:A:A:A:A:A:A:A:A:A:A:A:A:A:A:A:A:A:A:A:A:A:T:I
I:T:A:A:A:A:A:A:A:A:A:A:A:A:A:A:A:A:A:A:A:A:A:A:A:A:A:A:A:A:A:A:A:A:A:A:A:A:A:A:A:A:A:A:A:A:A:A:A:A:A:A:T:I
I:T:A:A:A:A:A:A:A:A:A:A:A:A:A:A:A:A:A:A:T:A:A:A:A:A:A:A:A:A:A:A:A:A:A:A:A:A:A:A:A:A:A:A:A:A:A:A:A:A:A:A:T:I
I:T:A:A:A:A:A:A:A:A:A:A:A:A:A:A:A:A:A:A:A:T:A:A:A:A:A:A:A:A:A:A:A:A:A:A:A:A:A:A:A:A:A:A:A:A:A:A:A:A:A:A:T:I
I:T:A:A:A:A:A:A:A:A:A:A:A:A:A:A:A:A:A:A:A:A:T:A:A:A:A:A:A:A:A:A:A:A:A:A:A:A:A:A:A:A:A:A:A:A:A:A:A:A:A:A:T:I
I:T:A:A:A:A:A:A:A:A:A:A:A:A:A:A:A:A:A:A:A:A:A:T:A:A:A:A:A:A:A:A:A:A:A:A:A:A:A:A:A:A:A:A:A:A:A:A:A:A:A:A:T:I
I:T:A:A:A:A:A:A:A:A:A:A:A:A:A:A:A:A:A:A:A:A:A:A:T:A:A:A:A:A:A:A:A:A:A:A:A:A:A:A:A:A:A:A:A:A:A:A:A:A:A:A:T:I
I:T:A:A:A:A:A:A:A:A:A:A:A:A:A:A:A:A:A:A:A:A:A:A:A:A:A:A:A:A:A:A:A:A:A:A:A:A:A:A:A:A:A:A:A:A:A:A:A:A:A:A:T:I
I:T:A:A:A:A:A:A:A:A:A:A:A:A:A:A:A:A:A:A:A:A:A:A:A:T:A:A:A:A:A:A:A:A:A:A:A:A:A:A:A:A:A:A:A:A:A:A:A:A:A:A:T:I
I:T:A:A:A:A:A:A:A:A:A:A:A:A:A:A:A:A:A:A:A:A:A:A:A:A:A:A:A:A:A:A:A:A:A:A:A:A:A:A:A:A:A:A:A:A:A:A:A:A:A:A:T:I
I:T:A:A:A:A:A:A:A:A:A:A:A:A:A:A:A:A:A:A:A:A:A:A:A:A:T:A:A:A:A:A:A:A:A:A:A:A:A:A:A:A:A:A:A:A:A:A:A:A:A:A:T:I
I:T:A:A:A:A:A:A:A:A:A:A:A:A:A:A:A:A:A:A:A:A:A:A:A:A:A:T:A:A:A:A:A:A:A:A:A:A:A:A:A:A:A:A:A:A:A:A:A:A:A:A:T:I
I:T:A:A:A:A:A:A:A:A:A:A:A:A:A:A:A:A:A:A:A:A:A:A:A:A:A:A:T:A:A:A:A:A:A:A:A:A:A:A:A:A:A:A:A:A:A:A:A:A:A:A:T:I
I:T:A:A:A:A:A:A:A:A:A:A:A:A:A:A:A:A:A:A:A:A:A:A:A:A:A:A:A:A:A:A:A:A:A:A:A:A:A:A:A:A:A:A:A:A:A:A:A:A:A:A:T:I
I:T:A:A:A:A:A:A:A:A:A:A:A:A:A:A:A:A:A:A:A:A:A:A:A:A:A:A:A:T:T:A:A:A:A:A:A:A:A:A:A:A:A:A:A:A:A:A:A:A:A:A:T:I
I:T:T:A:A:A:A:A:A:A:A:A:A:A:A:A:A:A:A:A:A:A:A:A:A:A:A:A:A:T:T:A:A:A:A:A:A:A:A:A:A:A:A:A:A:A:A:A:A:A:A:A:T:I
I:T:T:A:A:A:A:A:A:A:A:A:A:A:A:A:A:A:A:A:A:A:A:A:A:A:A:A:A:T:T:A:A:A:A:A:A:A:A:A:A:A:A:A:A:A:A:A:A:A:A:A:T:I
I:T:T:A:A:A:A:A:A:A:A:A:A:A:A:A:A:A:A:A:A:A:A:A:A:A:A:A:A:T:T:A:A:A:A:A:A:A:A:A:A:A:A:A:A:A:A:A:A:A:A:A:T:I
I:T:T:A:A:A:A:A:A:A:A:A:A:A:A:A:A:A:A:A:A:A:A:A:A:A:A:A:A:T:T:A:A:A:A:A:A:A:A:A:A:A:A:A:A:A:A:A:A:A:A:A:T:I
I:T:T:A:A:A:A:A:A:A:A:A:A:A:A:A:A:A:A:A:A:A:A:A:A:A:A:A:A:T:T:A:A:A:A:A:A:A:A:A:A:A:A:A:A:A:A:A:A:A:A:A:T:I
I:T:T:A:A:A:A:A:A:A:A:A:A:A:A:A:A:A:A:A:A:A:A:A:A:A:A:A:A:T:T:A:A:A:A:A:A:A:A:A:A:A:A:A:A:A:A:A:A:A:A:A:T:I
I:T:T:A:A:A:A:A:A:A:A:A:A:A:A:A:A:A:A:A:A:A:A:A:A:A:A:A:A:T:T:A:A:A:A:A:A:A:A:A:A:A:A:A:A:A:A:A:A:A:A:A:T:I
I:T:T:A:A:A:A:A:A:A:A:A:A:A:A:A:A:A:A:A:A:A:A:A:A:A:A:A:A:T:T:A:A:A:A:A:A:A:A:A:A:A:A:A:A:A:A:A:A:A:A:A:T:I
I:T:T:A:A:A:A:A:A:A:A:A:A:A:A:A:A:A:A:A:A:A:A:A:A:A:A:A:A:T:T:A:A:A:A:A:A:A:A:A:A:A:A:A:A:A:A:A:A:A:A:A:T:I
I:T:T:A:A:A:A:A:A:A:A:A:A:A:A:A:A:A:A:A:A:A:A:A:A:A:A:A:A:T:T:A:A:A:A:A:A:A:A:A:A:A:A:A:A:A:A:A:A:A:A:A:T:I
I:T:T:A:A:A:A:A:A:A:A:A:A:A:A:A:A:A:A:A:A:A:A:A:A:A:A:A:A:T:T:A:A:A:A:A:A:A:A:A:A:A:A:A:A:A:A:A:A:A:A:A:T:I
I:T:T:A:A:A:A:A:A:A:A:A:A:A:A:A:A:A:A:A:A:A:A:A:A:A:A:A:A:T:T:A:A:A:A:A:A:A:A:A:A:A:A:A:A:A:A:A:A:A:A:A:T:I
I:T:T:A:A:A:A:A:A:A:A:A:A:A:A:A:A:A:A:A:A:A:A:A:A:A:A:A:A:T:T:A:A:A:A:A:A:A:A:A:A:A:A:A:A:A:A:A:A:A:A:A:T:I
I:T:T:A:A:A:A:A:A:A:A:A:A:A:A:A:A:A:A:A:A:A:A:A:A:A:A:A:A:T:T:A:A:A:A:A:A:A:A:A:A:A:A:A:A:A:A:A:A:A:A:A:T:I
I:T:T:A:A:A:A:A:A:A:A:A:A:A:A:A:A:A:A:A:A:A:A:A:A:A:A:A:A:T:T:A:A:A:A:A:A:A:A:A:A:A:A:A:A:A:A:A:A:A:A:A:T:I
I:T:T:A:A:A:A:A:A:A:A:A:A:A:A:A:A:A:A:A:A:A:A:A:A:A:A:A:A:T:T:A:A:A:A:A:A:A:A:A:A:A:A:A:A:A:A:A:A:A:A:A:T:I
I:T:T:A:A:A:A:A:A:A:A:A:A:A:A:A:A:A:A:A:A:A:A:A:A:A:A:A:A:T:T:A:A:A:A:A:A:A:A:A:A:A:A:A:A:A:A:A:A:A:A:A:T:I
I:T:T:A:A:A:A:A:A:A:A:A:A:A:A:A:A:A:A:A:A:A:A:A:A:A:A:A:A:T:T:A:A:A:A:A:A:A:A:A:A:A:A:A:A:A:A:A:A:A:A:A:T:I
I:T:T:A:A:A:A:A:A:A:A:A:A:A:A:A:A:A:A:A:A:A:A:A:A:A:A:A:A:T:T:A:A:A:A:A:A:A:A:A:A:A:A:A:A:A:A:A:A:A:A:A:T:I
I:T:T:A:A:A:A:A:A:A:A:A:A:A:A:A:A:A:A:A:A:A:A:A:A:A:A:A:A:T:T:A:A:A:A:A:A:A:A:A:A:A:A:A:A:A:A:A:A:A:A:A:T:I
I:T:T:A:A:A:A:A:A:A:A:A:A:A:A:A:A:A:A:A:A:A:A:A:A:A:A:A:A:T:T:A:A:A:A:A:A:A:A:A:A:A:A:A:A:A:A:A:A:A:A:A:T:I
I:T:T:A:A:A:A:A:A:A:A:A:A:A:A:A:A:A:A:A:A:A:A:A:A:A:A:A:A:T:T:A:A:A:A:A:A:A:A:A:A:A:A:A:A:A:A:A:A:A:A:A:T:I
I:T:A:A:A:A:A:A:A:A:A:A:A:A:A:A:A:A:A:A:A:A:A:A:A:A:A:A:A:T:T:A:A:A:A:A:A:A:A:A:A:A:A:A:A:A:A:A:A:A:A:A:T:I
I:I:I:I:I:I:I:I:I:I:I:I:I:I:I:I:I:I:I:I:I:I:I:I:I:I:I:I:I:I:I:I:I:I:I:I:I:I:I:I:I:I:I:I:I:I:I:I:I:I:I:I:I:I
