T:A:A:A:A:A:A:A:A:T
T:A:A:A:A:A:A:A:A:T
T:A:A:A:A:A:A:A:A:T
T:A:A:A:A:A:A:A:A:T
T:A:A:A:A:A:A:A:A:T
T:A:A:A:A:A:A:A:A:T
T:T:T:T:T:T:T:T:T:T
T:T:T:T:T:T:T:T:T:T
T:T:T:T:T:T:T:T:T:T
T:T:T:T:T:T:T:T:T:A
